model.armour.foot.chain	Foot Chain
model.armour.foot.cotton	Foot Cotton
model.armour.foot.dragon.leather	Foot Dragon Leather
model.armour.foot.dragon.scale	Foot Dragon Scale
model.armour.foot.leather	Foot Leather
model.armour.foot.plate	Foot Plate
model.armour.foot.studded	Foot Studded
model.armour.hand.chain	Hand Chain
model.armour.hand.cotton	Hand Cotton
model.armour.hand.dragon.leather	Hand Dragon Leather
model.armour.hand.dragon.scale	Hand Dragon Scale
model.armour.hand.leather	Hand Leather
model.armour.hand.plate	Hand Plate
model.armour.hand.studded	Hand Studded
model.armour.head.basinet	Head Basinet
model.armour.head.basinet.adamantine	Head Basinet Adamantine
model.armour.head.blue.cotton	Head Blue Cotton
model.armour.head.blue.cotton.equipped	Head Blue Cotton Equipped
model.armour.head.brownbear	Head Brownbear
model.armour.head.chain.adamantine.equipped	Head Chain Adamantine Equipped
model.armour.head.chain.equipped	Head Chain Equipped
model.armour.head.chain.gold	Head Chain Gold
model.armour.head.cotton	Head Cotton
model.armour.head.cotton.equipped	Head Cotton Equipped
model.armour.head.dragon.leather	Head Dragon Leather
model.armour.head.dragon.leather.red	Head Dragon Leather Red
model.armour.head.goblin.war.bonnet	Head Goblin War Bonnet
model.armour.head.greathelm	Head Greathelm
model.armour.head.greathelm.adamantine	Head Greathelm Adamantine
model.armour.head.greathelmHornedOfGold	Head GreathelmHornedOfGold
model.armour.head.greathelmWolf	Head GreathelmWolf
model.armour.head.hat.witch	Head Hat Witch
model.armour.head.hat1.leather	Head Hat1 Leather
model.armour.head.hat1.leather	Head Hat1 Leather
model.armour.head.leather	Head Leather
model.armour.head.leather.hat4	Head Leather Hat4
model.armour.head.mask.blank.paper	Head Mask Blank Paper
model.armour.head.mask.blank.paper.equipped.female	Head Mask Blank Paper Equipped Female
model.armour.head.mask.challenge.silver	Head Mask Challenge Silver
model.armour.head.mask.enlightened.leather	Head Mask Enlightened Leather
model.armour.head.mask.isles.pottery	Head Mask Isles Pottery
model.armour.head.mask.midsummer	Head Mask Midsummer
model.armour.head.mask.pale.pottery	Head Mask Pale Pottery
model.armour.head.mask.ravager.leather	Head Mask Ravager Leather
model.armour.head.mask.returner.leather	Head Mask Returner Leather
model.armour.head.mask.shadow.leather	Head Mask Shadow Leather
model.armour.head.mask.skull	Head Mask Skull
model.armour.head.mask.skull.gold	Head Mask Skull Gold
model.armour.head.mask.troll	Head Mask Troll
model.armour.head.mask.unfinished	Head Mask Unfinished
model.armour.head.openhelm	Head Openhelm
model.armour.head.openhelm.adamantine	Head Openhelm Adamantine
model.armour.head.openhelmplumedhunt	Head Openhelmplumedhunt
model.armour.head.studded	Head Studded
model.armour.head.troll.king.hat	Head Troll King Hat
model.armour.head.wool.cap0	Head Wool Cap0
model.armour.head.wool.cap0.yellow	Head Wool Cap0 Yellow
model.armour.head.wool.hat1	Head Wool Hat1
model.armour.head.wool.hat1.blue	Head Wool Hat1 Blue
model.armour.head.wool.hat2	Head Wool Hat2
model.armour.head.wool.hat2.dark	Head Wool Hat2 Dark
model.armour.head.wool.hat3	Head Wool Hat3
model.armour.head.wool.hat3.green	Head Wool Hat3 Green
model.armour.head.wool.hat4	Head Wool Hat4
model.armour.head.wool.hat4.green	Head Wool Hat4 Green
model.armour.leg.chain	Leg Chain
model.armour.leg.cotton	Leg Cotton
model.armour.leg.dragon.leather	Leg Dragon Leather
model.armour.leg.dragon.scale	Leg Dragon Scale
model.armour.leg.leather	Leg Leather
model.armour.leg.plate	Leg Plate
model.armour.leg.studded	Leg Studded
model.armour.shoul.1	Shoul 1
model.armour.shoul.10.left	Shoul 10 Left
model.armour.shoul.10.right	Shoul 10 Right
model.armour.shoul.11	Shoul 11
model.armour.shoul.12	Shoul 12
model.armour.shoul.13	Shoul 13
model.armour.shoul.14	Shoul 14
model.armour.shoul.15	Shoul 15
model.armour.shoul.16	Shoul 16
model.armour.shoul.17	Shoul 17
model.armour.shoul.18	Shoul 18
model.armour.shoul.2	Shoul 2
model.armour.shoul.3	Shoul 3
model.armour.shoul.4	Shoul 4
model.armour.shoul.5	Shoul 5
model.armour.shoul.6	Shoul 6
model.armour.shoul.7.left	Shoul 7 Left
model.armour.shoul.7.right	Shoul 7 Right
model.armour.shoul.8.left	Shoul 8 Left
model.armour.shoul.8.right	Shoul 8 Right
model.armour.shoul.9.left	Shoul 9 Left
model.armour.sleeve.chain	Sleeve Chain
model.armour.sleeve.cotton	Sleeve Cotton
model.armour.sleeve.dragon.leather	Sleeve Dragon Leather
model.armour.sleeve.dragon.scale	Sleeve Dragon Scale
model.armour.sleeve.leather	Sleeve Leather
model.armour.sleeve.plate	Sleeve Plate
model.armour.sleeve.red.cotton	Sleeve Red Cotton
model.armour.sleeve.studded	Sleeve Studded
model.armour.summerhat	Summerhat
model.armour.torso.chain	Torso Chain
model.armour.torso.cotton	Torso Cotton
model.armour.torso.dragon.leather	Torso Dragon Leather
model.armour.torso.dragon.scale	Torso Dragon Scale
model.armour.torso.leather	Torso Leather
model.armour.torso.plate	Torso Plate
model.armour.torso.red.cotton	Torso Red Cotton
model.armour.torso.robe.hots	Torso Robe Hots
model.armour.torso.robe.jenn	Torso Robe Jenn
model.armour.torso.robe.molr	Torso Robe Molr
model.armour.torso.studded	Torso Studded
model.arrow	Arrow
model.arrow.ballista	Arrow Ballista
model.arrow.head.ballista	Arrow Head Ballista
model.arrow.head.batteringram	Arrow Head Batteringram
model.arrow.head.war	Arrow Head War
model.arrow.shaft	Arrow Shaft
model.artifact.bloodang.crystal	Artifact Bloodang Crystal
model.artifact.charm	Artifact Charm
model.artifact.cherry.green.vegetarian	Artifact Cherry Green Vegetarian
model.artifact.cherry.red.vegetarian	Artifact Cherry Red Vegetarian
model.artifact.crownmight.gold	Artifact Crownmight Gold
model.artifact.ear	Artifact Ear
model.artifact.eye.crystal	Artifact Eye Crystal
model.artifact.finger	Artifact Finger
model.artifact.hammerhuge.bronze	Artifact Hammerhuge Bronze
model.artifact.libramnight.paper	Artifact Libramnight Paper
model.artifact.mouth.crystal	Artifact Mouth Crystal
model.artifact.orbdoom	Artifact Orbdoom
model.artifact.scail	Artifact Scail
model.artifact.sceptreascension.steel	Artifact Sceptreascension Steel
model.artifact.scrollbind.paper	Artifact Scrollbind Paper
model.artifact.smokesol.crystal	Artifact Smokesol Crystal
model.artifact.swordtwo	Artifact Swordtwo
model.artifact.tomemagic.green.paper	Artifact Tomemagic Green Paper
model.artifact.tomemagic.red.paper	Artifact Tomemagic Red Paper
model.artifact.walnut.vegetarian	Artifact Walnut Vegetarian
model.bait.cheese	Bait Cheese
model.bait.corn	Bait Corn
model.bait.dough	Bait Dough
model.bait.fish	Bait Fish
model.bait.grub	Bait Grub
model.bait.wheat	Bait Wheat
model.bait.wurm	Bait Wurm
model.blob	Blob
model.blob.corpse	Blob Corpse
model.board.village.cache	Board Village Cache
model.board.village.stone	Board Village Stone
model.bow	Bow
model.bow.long	Bow Long
model.bow.medium	Bow Medium
model.bread	Bread
model.bread.crumbs	Bread Crumbs
model.bread.slice	Bread Slice
model.bread.toast	Bread Toast
model.bush	Bush
model.bush.blueberry	Bush Blueberry
model.bush.camellia	Bush Camellia
model.bush.camellia.winter	Bush Camellia Winter
model.bush.grape	Bush Grape
model.bush.grape.winter	Bush Grape Winter
model.bush.hazelnut	Bush Hazelnut
model.bush.hazelnut.winter	Bush Hazelnut Winter
model.bush.lavendel.winter	Bush Lavendel Winter
model.bush.lingonberry	Bush Lingonberry
model.bush.lingonberry.winter	Bush Lingonberry Winter
model.bush.oleander	Bush Oleander
model.bush.oleander.winter	Bush Oleander Winter
model.bush.raspberry	Bush Raspberry
model.bush.raspberry.winter	Bush Raspberry Winter
model.bush.rose	Bush Rose
model.bush.rose.winter	Bush Rose Winter
model.bush.thorn	Bush Thorn
model.bush.thorn.winter	Bush Thorn Winter
model.cage.bison	Cage Bison
model.cage.bison.decayed	Cage Bison Decayed
model.cage.bull	Cage Bull
model.cage.bull.decayed	Cage Bull Decayed
model.cage.cow	Cage Cow
model.cage.cow.decayed	Cage Cow Decayed
model.cage.empty	Cage Empty
model.cage.empty.decayed	Cage Empty Decayed
model.cage.foal	Cage Foal
model.cage.foal.decayed	Cage Foal Decayed
model.cage.generic	Cage Generic
model.cage.generic.decayed	Cage Generic Decayed
model.cage.hellhorse	Cage Hellhorse
model.cage.hellhorse.decayed	Cage Hellhorse Decayed
model.cage.horse	Cage Horse
model.cage.horse.decayed	Cage Horse Decayed
model.cage.ram	Cage Ram
model.cage.ram.decayed	Cage Ram Decayed
model.cage.sheep	Cage Sheep
model.cage.sheep.decayed	Cage Sheep Decayed
model.cage.unfinished	Cage Unfinished
model.clothing.belt	Clothing Belt
model.clothing.belt.toolbelt	Clothing Belt Toolbelt
model.clothing.head.cap.soft.cotton.red	Clothing Head Cap Soft Cotton Red
model.clothing.scabbard	Clothing Scabbard
model.coin	Coin
model.coin.gold	Coin Gold
model.coin.iron	Coin Iron
model.coin.silver	Coin Silver
model.compass	Compass
model.container	Model Container
model.container.almanac	Almanac
model.container.backpack	Backpack
model.container.barrel	Barrel
model.container.barrel.huge	Barrel Huge
model.container.barrel.huge.decayed	Barrel Huge Decayed
model.container.barrel.huge.oil	Barrel Huge Oil
model.container.barrel.huge.oil.unfinished	Barrel Huge Oil Unfinished
model.container.barrel.large	Barrel Large
model.container.barrel.large.decayed	Barrel Large Decayed
model.container.barrel.large.unfinished	Barrel Large Unfinished
model.container.barrel.small.decayed	Barrel Small Decayed
model.container.barrel.small.unfinished	Barrel Small Unfinished
model.container.book	Book
model.container.bowl	Bowl
model.container.bowl.pottery	Bowl Pottery
model.container.bucket.small	Bucket Small
model.container.bucket.small.decayed	Bucket Small Decayed
model.container.bulk.unit	Bulk Unit
model.container.bulk.unit.unfinished	Bulk Unit Unfinished
model.container.caketin	Caketin
model.container.champagne	Champagne
model.container.chest.large	Chest Large
model.container.chest.large.decayed	Chest Large Decayed
model.container.chest.large.magical	Chest Large Magical
model.container.chest.large.treasure	Chest Large Treasure
model.container.chest.large.treasure.arch	Chest Large Treasure Arch
model.container.chest.large.unfinished	Chest Large Unfinished
model.container.chest.large.unfinished.decayed	Chest Large Unfinished Decayed
model.container.chest.small	Chest Small
model.container.chest.small.decayed	Chest Small Decayed
model.container.chest.small.magical	Chest Small Magical
model.container.chest.small.unfinished	Chest Small Unfinished
model.container.chest.small.unfinished.decayed	Chest Small Unfinished Decayed
model.container.coop.chicken	Coop Chicken
model.container.coop.chicken.decayed	Coop Chicken Decayed
model.container.coop.chicken.egg	Coop Chicken Egg
model.container.coop.chicken.egg.decayed	Coop Chicken Egg Decayed
model.container.coop.egg	Coop Egg
model.container.coop.egg.decayed	Coop Egg Decayed
model.container.coop.empty	Coop Empty
model.container.coop.empty.decayed	Coop Empty Decayed
model.container.coop.unfinished	Coop Unfinished
model.container.coop.unfinished.decayed	Coop Unfinished Decayed
model.container.crate.huge	Crate Huge
model.container.crate.huge.empty	Crate Huge Empty
model.container.crate.huge.sealed	Crate Huge Sealed
model.container.crate.huge.unfinished	Crate Huge Unfinished
model.container.crate.large	Crate Large
model.container.crate.large.empty	Crate Large Empty
model.container.crate.large.sealed	Crate Large Sealed
model.container.crate.large.unfinished	Crate Large Unfinished
model.container.crate.small	Crate Small
model.container.crate.small.empty	Crate Small Empty
model.container.crate.small.sealed	Crate Small Sealed
model.container.crate.small.unfinished	Crate Small Unfinished
model.container.dredge	Dredge
model.container.dredge.unfinished	Dredge Unfinished
model.container.flask	Flask
model.container.flask.pottery	Flask Pottery
model.container.flowerpot.clay	Flowerpot Clay
model.container.flowerpot.pottery	Flowerpot Pottery
model.container.flowerpotBlue	FlowerpotBlue
model.container.flowerpotDotted	FlowerpotDotted
model.container.flowerpotGreenish	FlowerpotGreenish
model.container.flowerpotOrange	FlowerpotOrange
model.container.flowerpotPurple	FlowerpotPurple
model.container.flowerpotWhite	FlowerpotWhite
model.container.flowerpotYellow	FlowerpotYellow
model.container.giftbox.blue	Giftbox Blue
model.container.giftbox.green	Giftbox Green
model.container.hive	Hive
model.container.hive.queen	Hive Queen
model.container.hive.unfinished	Hive Unfinished
model.container.hive.wild	Hive Wild
model.container.jar	Jar
model.container.jar.pottery	Jar Pottery
model.container.journal	Journal
model.container.knapsack	Knapsack
model.container.knapsack.iron	Knapsack Iron
model.container.measuringjug.clay	Measuringjug Clay
model.container.measuringjug.pottery	Measuringjug Pottery
model.container.mountbag	Mountbag
model.container.mountbag.xmas	Mountbag Xmas
model.container.net.fish.unfinished	Net Fish Unfinished
model.container.net.fishcotton	Net Fishcotton
model.container.net.keep	Net Keep
model.container.net.keep.planted	Net Keep Planted
model.container.piedish.clay	Piedish Clay
model.container.piedish.pottery	Piedish Pottery
model.container.plate	Plate
model.container.quiver	Quiver
model.container.rack.amphora.full	Rack Amphora Full
model.container.rack.barrel	Rack Barrel
model.container.rack.barrel.full	Rack Barrel Full
model.container.rack.bsb.empty	Rack Bsb Empty
model.container.rack.bsb.full	Rack Bsb Full
model.container.rack.bsb.unfinished	Rack Bsb Unfinished
model.container.rack.crate.empty	Rack Crate Empty
model.container.rack.crate.full	Rack Crate Full
model.container.rack.planter.empty	Rack Planter Empty
model.container.rack.planter.full	Rack Planter Full
model.container.rack.planter.unfinished	Rack Planter Unfinished
model.container.rack.winebarrel	Rack Winebarrel
model.container.rack.winebarrel.full	Rack Winebarrel Full
model.container.roastingdish.clay	Roastingdish Clay
model.container.roastingdish.pottery	Roastingdish Pottery
model.container.rods.empty	Rods Empty
model.container.rods.full	Rods Full
model.container.rods.unfinished	Rods Unfinished
model.container.satchel	Satchel
model.container.satchel	Satchel
model.container.smeltingpot.clay	Smeltingpot Clay
model.container.smeltingpot.pottery	Smeltingpot Pottery
model.container.spiritcastle	Spiritcastle
model.container.spiritcastle.unfinished	Spiritcastle Unfinished
model.container.spiritcottage	Spiritcottage
model.container.spiritcottage.unfinished	Spiritcottage Unfinished
model.container.spirithouse	Spirithouse
model.container.spirithouse.unfinished	Spirithouse Unfinished
model.container.spiritmansion	Spiritmansion
model.container.still.copper	Still Copper
model.container.still.copper.lit	Still Copper Lit
model.container.still.unfinished	Still Unfinished
model.container.stoneware	Stoneware
model.container.storagebin.empty	Storagebin Empty
model.container.storagebin.empty.decayed	Storagebin Empty Decayed
model.container.storagebin.food	Storagebin Food
model.container.storagebin.food.empty	Storagebin Food Empty
model.container.storagebin.food.empty.decayed	Storagebin Food Empty Decayed
model.container.storagebin.food.unfinished	Storagebin Food Unfinished
model.container.storagebin.food.unfinished.decayed	Storagebin Food Unfinished Decayed
model.container.storagebin.full	Storagebin Full
model.container.storagebin.full.decayed	Storagebin Full Decayed
model.container.storagebin.trash.empty	Storagebin Trash Empty
model.container.storagebin.trash.full	Storagebin Trash Full
model.container.storagebin.trash.unfinished	Storagebin Trash Unfinished
model.container.storagebin.unfinished	Storagebin Unfinished
model.container.storagebin.unfinished.decayed	Storagebin Unfinished Decayed
model.container.tacklebox	Tacklebox
model.container.weapons.armour	Weapons Armour
model.container.weapons.armour.empty	Weapons Armour Empty
model.container.weapons.armour.unfinished	Weapons Armour Unfinished
model.container.weapons.bows	Weapons Bows
model.container.weapons.bows.empty	Weapons Bows Empty
model.container.weapons.bows.unfinished	Weapons Bows Unfinished
model.container.weapons.empty	Weapons Empty
model.container.weapons.full	Weapons Full
model.container.weapons.polearms.empty	Weapons Polearms Empty
model.container.weapons.polearms.full	Weapons Polearms Full
model.container.weapons.polearms.unfinished	Weapons Polearms Unfinished
model.container.weapons.unfinished	Weapons Unfinished
model.container.winebarrel.small	Winebarrel Small
model.container.winebarrel.small.unfinished	Winebarrel Small Unfinished
model.corpse	Model Corpse
model.corpse.anaconda	Anaconda
model.corpse.bison	Bison
model.corpse.blackbear	Blackbear
model.corpse.blackbear.butchered	Blackbear Butchered
model.corpse.blackdragon	Blackdragon
model.corpse.blackdragonhatchling	Blackdragonhatchling
model.corpse.blackwolf	Blackwolf
model.corpse.blackwolf.butchered	Blackwolf Butchered
model.corpse.bluedragon	Bluedragon
model.corpse.bluedragonhatchling	Bluedragonhatchling
model.corpse.bluewhale	Bluewhale
model.corpse.brownbear	Brownbear
model.corpse.brownbear.butchered	Brownbear Butchered
model.corpse.browncow	Browncow
model.corpse.bull	Bull
model.corpse.calf	Calf
model.corpse.cavebug	Cavebug
model.corpse.chicken	Chicken
model.corpse.crab	Crab
model.corpse.crocodile	Crocodile
model.corpse.deathcrawlerminion	Deathcrawlerminion
model.corpse.deer	Deer
model.corpse.deer.female	Deer Female
model.corpse.dog	Dog
model.corpse.dog.butchered	Dog Butchered
model.corpse.dolphin	Dolphin
model.corpse.easterbunny	Easterbunny
model.corpse.foal	Foal
model.corpse.foal.brown	Foal Brown
model.corpse.fogspider	Fogspider
model.corpse.forestgiant	Forestgiant
model.corpse.goblin	Goblin
model.corpse.greendragon	Greendragon
model.corpse.greendragonhatchling	Greendragonhatchling
model.corpse.hellhorse	Hellhorse
model.corpse.hellhorse.envious	Hellhorse Envious
model.corpse.hellhorse.foal	Hellhorse Foal
model.corpse.hellhorse.foal.envious	Hellhorse Foal Envious
model.corpse.hellhound	Hellhound
model.corpse.hellscorpious	Hellscorpious
model.corpse.hen	Hen
model.corpse.hen.brown	Hen Brown
model.corpse.hen.butchered	Hen Butchered
model.corpse.horse	Horse
model.corpse.horse.grey	Horse Grey
model.corpse.hugeshark	Hugeshark
model.corpse.hugespider	Hugespider
model.corpse.hugespider	Hugespider
model.corpse.hugespider.butchered	Hugespider Butchered
model.corpse.human.butchered	Human Butchered
model.corpse.human.evilsanta	Human Evilsanta
model.corpse.human.santaclaus	Human Santaclaus
model.corpse.jenn-kellontowerguard	Jenn-kellontowerguard
model.corpse.jenn-kellontowerguard.female	Jenn-kellontowerguard Female
model.corpse.kyklops	Kyklops
model.corpse.lamb	Lamb
model.corpse.lamb.black	Lamb Black
model.corpse.largerat	Largerat
model.corpse.lavafiend	Lavafiend
model.corpse.lavaspider	Lavaspider
model.corpse.lavaspider.butchered	Lavaspider Butchered
model.corpse.mountaingorilla	Mountaingorilla
model.corpse.mountaingorilla.butchered	Mountaingorilla Butchered
model.corpse.mountainlion	Mountainlion
model.corpse.octopus	Octopus
model.corpse.octopus.black	Octopus Black
model.corpse.pheasant	Pheasant
model.corpse.pig	Pig
model.corpse.pig.butchered	Pig Butchered
model.corpse.rabidhyena	Rabidhyena
model.corpse.ram	Ram
model.corpse.ram.black	Ram Black
model.corpse.reddragon	Reddragon
model.corpse.reddragonhatchling	Reddragonhatchling
model.corpse.riftbeast	Riftbeast
model.corpse.riftcaster	Riftcaster
model.corpse.riftjackal	Riftjackal
model.corpse.riftogre	Riftogre
model.corpse.riftogremage	Riftogremage
model.corpse.rooster	Rooster
model.corpse.rooster.brown	Rooster Brown
model.corpse.scorpion	Scorpion
model.corpse.seal	Seal
model.corpse.sealcub	Sealcub
model.corpse.seaserpent	Seaserpent
model.corpse.sheep	Sheep
model.corpse.sheep.black	Sheep Black
model.corpse.soldemon	Soldemon
model.corpse.sonofnogump	Sonofnogump
model.corpse.spawnofuttacha	Spawnofuttacha
model.corpse.spawnofuttacha.butchered	Spawnofuttacha Butchered
model.corpse.tortoise	Tortoise
model.corpse.troll	Troll
model.corpse.trollking	Trollking
model.corpse.unicorn	Unicorn
model.corpse.unicorn.butchered	Unicorn Butchered
model.corpse.unicorn.foal	Unicorn Foal
model.corpse.unicorn.foal.butchered	Unicorn Foal Butchered
model.corpse.whitedragon	Whitedragon
model.corpse.whitedragonhatchling	Whitedragonhatchling
model.corpse.wildboar	Wildboar
model.corpse.wildboar.butchered	Wildboar Butchered
model.corpse.wildcat	Wildcat
model.corpse.wildcat.butchered	Wildcat Butchered
model.corpse.worg	Worg
model.corpse.zombie.butchered	Zombie Butchered
model.creature	Model Creature
model.creature.deathcrawler	Deathcrawler
model.creature.dragon.black	Dragon Black
model.creature.dragon.blue	Dragon Blue
model.creature.dragon.green	Dragon Green
model.creature.dragon.red	Dragon Red
model.creature.dragon.white	Dragon White
model.creature.drake.black	Drake Black
model.creature.drake.blue	Drake Blue
model.creature.drake.green	Drake Green
model.creature.drake.red	Drake Red
model.creature.drake.spirit	Drake Spirit
model.creature.drake.white	Drake White
model.creature.eagle.spirit	Eagle Spirit
model.creature.fish	Fish
model.creature.fish.bass	Fish Bass
model.creature.fish.blue.whale	Fish Blue Whale
model.creature.fish.blueshark	Fish Blueshark
model.creature.fish.carp	Fish Carp
model.creature.fish.catfish	Fish Catfish
model.creature.fish.clam	Fish Clam
model.creature.fish.dolphin	Fish Dolphin
model.creature.fish.dorado	Fish Dorado
model.creature.fish.herring	Fish Herring
model.creature.fish.loach	Fish Loach
model.creature.fish.marlin	Fish Marlin
model.creature.fish.minnow	Fish Minnow
model.creature.fish.octopus	Fish Octopus
model.creature.fish.octopus.black	Fish Octopus Black
model.creature.fish.perch	Fish Perch
model.creature.fish.pike	Fish Pike
model.creature.fish.roach	Fish Roach
model.creature.fish.sailfish	Fish Sailfish
model.creature.fish.sardine	Fish Sardine
model.creature.fish.seal	Fish Seal
model.creature.fish.seal.cub	Fish Seal Cub
model.creature.fish.shark.huge	Fish Shark Huge
model.creature.fish.snook	Fish Snook
model.creature.fish.tuna	Fish Tuna
model.creature.fish.whiteshark	Fish Whiteshark
model.creature.fish.wurm	Fish Wurm
model.creature.gmdark	Gmdark
model.creature.humanoid.avenger.light	Humanoid Avenger Light
model.creature.humanoid.chicken	Humanoid Chicken
model.creature.humanoid.demon.sol	Humanoid Demon Sol
model.creature.humanoid.giant.epiphany	Humanoid Giant Epiphany
model.creature.humanoid.giant.forest	Humanoid Giant Forest
model.creature.humanoid.giant.incarnation	Humanoid Giant Incarnation
model.creature.humanoid.giant.juggernaut	Humanoid Giant Juggernaut
model.creature.humanoid.giant.manifestation	Humanoid Giant Manifestation
model.creature.humanoid.goblin	Humanoid Goblin
model.creature.humanoid.goblin.leader	Humanoid Goblin Leader
model.creature.humanoid.gorilla.mountain	Humanoid Gorilla Mountain
model.creature.humanoid.hen	Humanoid Hen
model.creature.humanoid.hen.brown	Humanoid Hen Brown
model.creature.humanoid.human.bartender	Humanoid Human Bartender
model.creature.humanoid.human.guard	Humanoid Human Guard
model.creature.humanoid.human.guard.tower.female	Humanoid Human Guard Tower Female
model.creature.humanoid.human.ladylake.female.jenn	Humanoid Human Ladylake Female Jenn
model.creature.humanoid.human.player	Humanoid Human Player
model.creature.humanoid.human.player.female	Humanoid Human Player Female
model.creature.humanoid.human.player.zombie	Humanoid Human Player Zombie
model.creature.humanoid.human.salesman	Humanoid Human Salesman
model.creature.humanoid.human.salesman.female	Humanoid Human Salesman Female
model.creature.humanoid.human.skeleton	Humanoid Human Skeleton
model.creature.humanoid.human.spirit	Humanoid Human Spirit
model.creature.humanoid.human.spirit.wraith	Humanoid Human Spirit Wraith
model.creature.humanoid.human.wagoner	Humanoid Human Wagoner
model.creature.humanoid.human.wagoner.female	Humanoid Human Wagoner Female
model.creature.humanoid.jackal.rift	Humanoid Jackal Rift
model.creature.humanoid.jackal.rift.caster	Humanoid Jackal Rift Caster
model.creature.humanoid.kyklops	Humanoid Kyklops
model.creature.humanoid.lavacreature	Humanoid Lavacreature
model.creature.humanoid.nogump.son	Humanoid Nogump Son
model.creature.humanoid.ogre.rift	Humanoid Ogre Rift
model.creature.humanoid.ogre.rift.mage	Humanoid Ogre Rift Mage
model.creature.humanoid.pheasant	Humanoid Pheasant
model.creature.humanoid.rooster	Humanoid Rooster
model.creature.humanoid.rooster.brown	Humanoid Rooster Brown
model.creature.humanoid.troll.king	Humanoid Troll King
model.creature.humanoid.troll.standard	Humanoid Troll Standard
model.creature.humanoid.warmaster.rift	Humanoid Warmaster Rift
model.creature.multiped.scorpion	Multiped Scorpion
model.creature.multiped.scorpion.hell	Multiped Scorpion Hell
model.creature.multiped.spider.fog	Multiped Spider Fog
model.creature.multiped.spider.huge	Multiped Spider Huge
model.creature.multiped.spider.huge	Multiped Spider Huge
model.creature.multiped.spider.lava	Multiped Spider Lava
model.creature.quadraped.bear.black	Quadraped Bear Black
model.creature.quadraped.bear.brown	Quadraped Bear Brown
model.creature.quadraped.beast.rift	Quadraped Beast Rift
model.creature.quadraped.bison	Quadraped Bison
model.creature.quadraped.bison.wagoner	Quadraped Bison Wagoner
model.creature.quadraped.bison.wagoner.male.xmas	Quadraped Bison Wagoner Male Xmas
model.creature.quadraped.boar.wild	Quadraped Boar Wild
model.creature.quadraped.bull	Quadraped Bull
model.creature.quadraped.calf	Quadraped Calf
model.creature.quadraped.cat.wild	Quadraped Cat Wild
model.creature.quadraped.cow	Quadraped Cow
model.creature.quadraped.crab	Quadraped Crab
model.creature.quadraped.crocodile	Quadraped Crocodile
model.creature.quadraped.deer.female	Quadraped Deer Female
model.creature.quadraped.deer.male	Quadraped Deer Male
model.creature.quadraped.dog	Quadraped Dog
model.creature.quadraped.dog.hell	Quadraped Dog Hell
model.creature.quadraped.easterbunny	Quadraped Easterbunny
model.creature.quadraped.foal	Quadraped Foal
model.creature.quadraped.foal.black	Quadraped Foal Black
model.creature.quadraped.horse	Quadraped Horse
model.creature.quadraped.horse.black	Quadraped Horse Black
model.creature.quadraped.horse.hell	Quadraped Horse Hell
model.creature.quadraped.horse.hell.ash	Quadraped Horse Hell Ash
model.creature.quadraped.horse.hell.envious	Quadraped Horse Hell Envious
model.creature.quadraped.horse.hell.foal	Quadraped Horse Hell Foal
model.creature.quadraped.horse.hell.foal.ash	Quadraped Horse Hell Foal Ash
model.creature.quadraped.horse.hell.foal.envious	Quadraped Horse Hell Foal Envious
model.creature.quadraped.hyena.rabid	Quadraped Hyena Rabid
model.creature.quadraped.insect.cavebug	Quadraped Insect Cavebug
model.creature.quadraped.lamb.male	Quadraped Lamb Male
model.creature.quadraped.lamb.male.black	Quadraped Lamb Male Black
model.creature.quadraped.lion.mountain.male	Quadraped Lion Mountain Male
model.creature.quadraped.pig	Quadraped Pig
model.creature.quadraped.rat	Quadraped Rat
model.creature.quadraped.rat	Quadraped Rat
model.creature.quadraped.rat	Quadraped Rat
model.creature.quadraped.sheep	Quadraped Sheep
model.creature.quadraped.sheep.female.black	Quadraped Sheep Female Black
model.creature.quadraped.sheep.male	Quadraped Sheep Male
model.creature.quadraped.sheep.male.black	Quadraped Sheep Male Black
model.creature.quadraped.tortoise	Quadraped Tortoise
model.creature.quadraped.unicorn	Quadraped Unicorn
model.creature.quadraped.unicorn.foal	Quadraped Unicorn Foal
model.creature.quadraped.wolf.black	Quadraped Wolf Black
model.creature.quadraped.wolf.worg	Quadraped Wolf Worg
model.creature.snake.anaconda	Snake Anaconda
model.creature.snake.kingcobra	Snake Kingcobra
model.creature.snake.serpent.sea	Snake Serpent Sea
model.creature.spawn.uttacha	Spawn Uttacha
model.decoration.altar	Altar
model.decoration.altar.gold.gold	Altar Gold Gold
model.decoration.altar.holy	Altar Holy
model.decoration.altar.silver	Altar Silver
model.decoration.altar.stone	Altar Stone
model.decoration.altar.unfinished	Altar Unfinished
model.decoration.altar.unfinished.stone	Altar Unfinished Stone
model.decoration.altar.unholy	Altar Unholy
model.decoration.amphora.large.clay	Amphora Large Clay
model.decoration.amphora.large.pottery	Amphora Large Pottery
model.decoration.amphora.small.clay	Amphora Small Clay
model.decoration.amphora.small.pottery	Amphora Small Pottery
model.decoration.archerytarget	Archerytarget
model.decoration.archerytarget.unfinished	Archerytarget Unfinished
model.decoration.armring	Armring
model.decoration.armring.adamantine	Armring Adamantine
model.decoration.armring.gold	Armring Gold
model.decoration.ball.copper	Ball Copper
model.decoration.ball.unfinished	Ball Unfinished
model.decoration.ball.unfinished.silver	Ball Unfinished Silver
model.decoration.banner	Banner
model.decoration.banner.molr	Banner Molr
model.decoration.banner.unfinished	Banner Unfinished
model.decoration.bell.small	Bell Small
model.decoration.bell.small.resonator	Bell Small Resonator
model.decoration.birdcage	Birdcage
model.decoration.birdcage.unfinished	Birdcage Unfinished
model.decoration.black.bear.rug	Black Bear Rug
model.decoration.black.wolf.rug	Black Wolf Rug
model.decoration.bowl	Bowl
model.decoration.bowl.gold	Bowl Gold
model.decoration.bowl.iron	Bowl Iron
model.decoration.brazier.bowl.copper	Brazier Bowl Copper
model.decoration.brazier.copper	Brazier Copper
model.decoration.brazier.copper.lit	Brazier Copper Lit
model.decoration.brazier.pillar.marble	Brazier Pillar Marble
model.decoration.brazier.pillar.marble.lit	Brazier Pillar Marble Lit
model.decoration.brazier.pillar.unfinished.marble	Brazier Pillar Unfinished Marble
model.decoration.brazier.stand.copper	Brazier Stand Copper
model.decoration.brazier.unfinished.copper	Brazier Unfinished Copper
model.decoration.brown.bear.rug	Brown Bear Rug
model.decoration.bucketfour	Bucketfour
model.decoration.bucketthree	Bucketthree
model.decoration.candelabra	Candelabra
model.decoration.candelabra.adamantine	Candelabra Adamantine
model.decoration.candelabra.copper	Candelabra Copper
model.decoration.candelabra.gold	Candelabra Gold
model.decoration.candelabra.iron	Candelabra Iron
model.decoration.carpet.medi.four	Carpet Medi Four
model.decoration.carpet.medi.one.unfinished	Carpet Medi One Unfinished
model.decoration.chain	Chain
model.decoration.colorful.carpet.large	Colorful Carpet Large
model.decoration.colorful.carpet.medium	Colorful Carpet Medium
model.decoration.colorful.carpet.small	Colorful Carpet Small
model.decoration.crown	Crown
model.decoration.crown.silver	Crown Silver
model.decoration.crown.steel	Crown Steel
model.decoration.ffcrystalball	Ffcrystalball
model.decoration.fine.high.chair	Fine High Chair
model.decoration.flag	Flag
model.decoration.flag.molr	Flag Molr
model.decoration.fountain	Fountain
model.decoration.fountain.2	Fountain 2
model.decoration.gem.diamond.crystal	Gem Diamond Crystal
model.decoration.gem.diamond.star	Gem Diamond Star
model.decoration.gem.emerald	Gem Emerald
model.decoration.gem.emerald.star	Gem Emerald Star
model.decoration.gem.opal.black	Gem Opal Black
model.decoration.gem.pearl	Gem Pearl
model.decoration.gem.pearl.black	Gem Pearl Black
model.decoration.gem.resurrectionstone	Gem Resurrectionstone
model.decoration.gem.ruby.crystal	Gem Ruby Crystal
model.decoration.gem.ruby.star	Gem Ruby Star
model.decoration.gem.sapphire	Gem Sapphire
model.decoration.gem.sapphire.star	Gem Sapphire Star
model.decoration.gem.teleportationstone	Gem Teleportationstone
model.decoration.gravestone	Gravestone
model.decoration.gravestone.buried	Gravestone Buried
model.decoration.gravestone.buried.decayed	Gravestone Buried Decayed
model.decoration.gravestone.decayed	Gravestone Decayed
model.decoration.hanger.axe	Hanger Axe
model.decoration.hanger.axe.unfinished	Hanger Axe Unfinished
model.decoration.hanger.sword	Hanger Sword
model.decoration.high.bookshelf	High Bookshelf
model.decoration.high.bookshelf.empty	High Bookshelf Empty
model.decoration.high.bookshelf.empty.unfinished	High Bookshelf Empty Unfinished
model.decoration.large.brazier.bowl	Large Brazier Bowl
model.decoration.low.bookshelf	Low Bookshelf
model.decoration.low.bookshelf.empty	Low Bookshelf Empty
model.decoration.low.bookshelf.empty.unfinished	Low Bookshelf Empty Unfinished
model.decoration.mountain.lion.rug	Mountain Lion Rug
model.decoration.necklace	Necklace
model.decoration.necklace.silver	Necklace Silver
model.decoration.pauper.high.chair	Pauper High Chair
model.decoration.pendulum.brass	Pendulum Brass
model.decoration.planter	Planter
model.decoration.planter.blue	Planter Blue
model.decoration.planter.purple	Planter Purple
model.decoration.planter.unfinished	Planter Unfinished
model.decoration.practicedoll	Practicedoll
model.decoration.practicedoll	Practicedoll
model.decoration.practicedoll.decay	Practicedoll Decay
model.decoration.practicedoll.unfinished	Practicedoll Unfinished
model.decoration.regular.high.chair	Regular High Chair
model.decoration.ring	Ring
model.decoration.ring.rift.1.seryll	Ring Rift 1 Seryll
model.decoration.ring.rift.5.seryll	Ring Rift 5 Seryll
model.decoration.ring.silver	Ring Silver
model.decoration.sceptre.birchwood	Sceptre Birchwood
model.decoration.sceptre.gold	Sceptre Gold
model.decoration.sceptre.hots	Sceptre Hots
model.decoration.sceptre.jenn	Sceptre Jenn
model.decoration.sceptre.molr	Sceptre Molr
model.decoration.snowman.xmas	Snowman Xmas
model.decoration.spring.source.stone	Spring Source Stone
model.decoration.statue.boy	Statue Boy
model.decoration.statue.boy.marble	Statue Boy Marble
model.decoration.statue.challenge.bronze	Statue Challenge Bronze
model.decoration.statue.challenge.gold	Statue Challenge Gold
model.decoration.statue.colossus	Statue Colossus
model.decoration.statue.colossus.fo	Statue Colossus Fo
model.decoration.statue.colossus.libila	Statue Colossus Libila
model.decoration.statue.colossus.magranon	Statue Colossus Magranon
model.decoration.statue.colossus.unfinished	Statue Colossus Unfinished
model.decoration.statue.colossus.vynora	Statue Colossus Vynora
model.decoration.statue.colossus.vynora.marble	Statue Colossus Vynora Marble
model.decoration.statue.demon.stone	Statue Demon Stone
model.decoration.statue.dog	Statue Dog
model.decoration.statue.drake	Statue Drake
model.decoration.statue.eagle	Statue Eagle
model.decoration.statue.fiend	Statue Fiend
model.decoration.statue.fo	Statue Fo
model.decoration.statue.garden	Statue Garden
model.decoration.statue.garden.green	Statue Garden Green
model.decoration.statue.girl	Statue Girl
model.decoration.statue.girl.marble	Statue Girl Marble
model.decoration.statue.goblin	Statue Goblin
model.decoration.statue.guard	Statue Guard
model.decoration.statue.hellhorse	Statue Hellhorse
model.decoration.statue.horse	Statue Horse
model.decoration.statue.horse.marble	Statue Horse Marble
model.decoration.statue.hota.bearfightingbull	Statue Hota Bearfightingbull
model.decoration.statue.hota.blackdragon	Statue Hota Blackdragon
model.decoration.statue.hota.deer	Statue Hota Deer
model.decoration.statue.hota.dogsfightingboar	Statue Hota Dogsfightingboar
model.decoration.statue.hota.femalefightinganaconda	Statue Hota Femalefightinganaconda
model.decoration.statue.hota.manfightingbear	Statue Hota Manfightingbear
model.decoration.statue.hota.nogump	Statue Hota Nogump
model.decoration.statue.hota.scorpion	Statue Hota Scorpion
model.decoration.statue.hota.soldemon	Statue Hota Soldemon
model.decoration.statue.hota.wolffightingbison	Statue Hota Wolffightingbison
model.decoration.statue.kyklops	Statue Kyklops
model.decoration.statue.libila	Statue Libila
model.decoration.statue.magranon	Statue Magranon
model.decoration.statue.mountainlion	Statue Mountainlion
model.decoration.statue.nymph	Statue Nymph
model.decoration.statue.nymph.marble	Statue Nymph Marble
model.decoration.statue.pifa	Statue Pifa
model.decoration.statue.pifa.marble	Statue Pifa Marble
model.decoration.statue.riftbeast	Statue Riftbeast
model.decoration.statue.snowman.water	Statue Snowman Water
model.decoration.statue.troll	Statue Troll
model.decoration.statue.troll.marble	Statue Troll Marble
model.decoration.statue.unicorn	Statue Unicorn
model.decoration.statue.vynora	Statue Vynora
model.decoration.statue.worg	Statue Worg
model.decoration.statuette	Statuette
model.decoration.statuette.brass	Statuette Brass
model.decoration.statuette.fo.silver	Statuette Fo Silver
model.decoration.statuette.knight.mine	Statuette Knight Mine
model.decoration.statuette.knight.sword	Statuette Knight Sword
model.decoration.statuette.libila.silver	Statuette Libila Silver
model.decoration.statuette.magranon.silver	Statuette Magranon Silver
model.decoration.statuette.silver	Statuette Silver
model.decoration.statuette.soldier.axe	Statuette Soldier Axe
model.decoration.statuette.soldier.dig	Statuette Soldier Dig
model.decoration.statuette.vynora.silver	Statuette Vynora Silver
model.decoration.tallbanner	Tallbanner
model.decoration.tallbanner.hots	Tallbanner Hots
model.decoration.tallbanner.jenn	Tallbanner Jenn
model.decoration.tallbanner.molr	Tallbanner Molr
model.decoration.thirstyaussiebar	Thirstyaussiebar
model.decoration.tree.christmas	Tree Christmas
model.decoration.trellis.grape	Trellis Grape
model.decoration.trellis.grape.harvestable	Trellis Grape Harvestable
model.decoration.trellis.grape.unfinished	Trellis Grape Unfinished
model.decoration.trellis.hops	Trellis Hops
model.decoration.trellis.hops.harvestable	Trellis Hops Harvestable
model.decoration.trellis.ivy	Trellis Ivy
model.decoration.trellis.ivy.unfinished	Trellis Ivy Unfinished
model.decoration.trellis.rose	Trellis Rose
model.decoration.trellis.rose.harvestable	Trellis Rose Harvestable
model.decoration.well.stone	Well Stone
model.decoration.well.unfinished.stone	Well Unfinished Stone
model.fallen.birch	Fallen Birch
model.fallen.birch.animatedfalling	Fallen Birch Animatedfalling
model.fallen.birch.animatedfalling.fall	Fallen Birch Animatedfalling Fall
model.fallen.cedar	Fallen Cedar
model.fallen.cedar.animatedfalling	Fallen Cedar Animatedfalling
model.fallen.cedar.animatedfalling.winter	Fallen Cedar Animatedfalling Winter
model.fallen.chestnut	Fallen Chestnut
model.fallen.chestnut.animatedfalling.spring	Fallen Chestnut Animatedfalling Spring
model.fallen.chestnut.animatedfalling.summer	Fallen Chestnut Animatedfalling Summer
model.fallen.fir	Fallen Fir
model.fallen.fir.animatedfalling	Fallen Fir Animatedfalling
model.fallen.fir.animatedfalling.winter	Fallen Fir Animatedfalling Winter
model.fallen.linden	Fallen Linden
model.fallen.linden.animatedfalling.spring	Fallen Linden Animatedfalling Spring
model.fallen.linden.animatedfalling.summer	Fallen Linden Animatedfalling Summer
model.fallen.maple	Fallen Maple
model.fallen.maple.animatedfalling	Fallen Maple Animatedfalling
model.fallen.maple.animatedfalling.fall	Fallen Maple Animatedfalling Fall
model.fallen.oak	Fallen Oak
model.fallen.oak.animatedfalling	Fallen Oak Animatedfalling
model.fallen.oak.animatedfalling.fall	Fallen Oak Animatedfalling Fall
model.fallen.pine	Fallen Pine
model.fallen.pine.animatedfalling	Fallen Pine Animatedfalling
model.fallen.pine.animatedfalling.winter	Fallen Pine Animatedfalling Winter
model.fallen.walnut	Fallen Walnut
model.fallen.walnut.animatedfalling.spring	Fallen Walnut Animatedfalling Spring
model.fallen.walnut.animatedfalling.summer	Fallen Walnut Animatedfalling Summer
model.fallen.willow	Fallen Willow
model.fallen.willow.animatedfalling	Fallen Willow Animatedfalling
model.fallen.willow.animatedfalling.fall	Fallen Willow Animatedfalling Fall
model.fireplace.campfire	Fireplace Campfire
model.fireplace.campfire.fish	Fireplace Campfire Fish
model.fireplace.campfire.fish.fillet	Fireplace Campfire Fish Fillet
model.fireplace.campfire.fish.fillet.unlit	Fireplace Campfire Fish Fillet Unlit
model.fireplace.campfire.fish.unlit	Fireplace Campfire Fish Unlit
model.fireplace.campfire.fryingpan	Fireplace Campfire Fryingpan
model.fireplace.campfire.fryingpan.unlit	Fireplace Campfire Fryingpan Unlit
model.fireplace.campfire.meat	Fireplace Campfire Meat
model.fireplace.campfire.meat.unlit	Fireplace Campfire Meat Unlit
model.fireplace.campfire.potterybowl	Fireplace Campfire Potterybowl
model.fireplace.campfire.potterybowl.unlit	Fireplace Campfire Potterybowl Unlit
model.fireplace.campfire.spit.lamb	Fireplace Campfire Spit Lamb
model.fireplace.campfire.spit.pig	Fireplace Campfire Spit Pig
model.fireplace.campfire.spit.pig.roasted	Fireplace Campfire Spit Pig Roasted
model.fireplace.campfire.spit.pig.roasted.unlit	Fireplace Campfire Spit Pig Roasted Unlit
model.fireplace.campfire.unlit	Fireplace Campfire Unlit
model.fireplace.charcoalpile	Fireplace Charcoalpile
model.fireplace.forge.stone	Fireplace Forge Stone
model.fireplace.forge.stone.lit	Fireplace Forge Stone Lit
model.fireplace.forge.unfinished	Fireplace Forge Unfinished
model.fireplace.kiln	Fireplace Kiln
model.fireplace.kiln.unfinished	Fireplace Kiln Unfinished
model.fireplace.open.decorative	Fireplace Open Decorative
model.fireplace.open.decorative.unfinished	Fireplace Open Decorative Unfinished
model.fireplace.oven.stone	Fireplace Oven Stone
model.fireplace.oven.stone.lit	Fireplace Oven Stone Lit
model.fireplace.oven.unfinished	Fireplace Oven Unfinished
model.fireplace.smelter	Fireplace Smelter
model.fireplace.smelter.unfinished	Fireplace Smelter Unfinished
model.fireworks.birchwood	Fireworks Birchwood
model.fish.bass	Fish Bass
model.fish.blueshark	Fish Blueshark
model.fish.carp	Fish Carp
model.fish.catfish	Fish Catfish
model.fish.clam	Fish Clam
model.fish.dorado	Fish Dorado
model.fish.herring	Fish Herring
model.fish.loach	Fish Loach
model.fish.marlin	Fish Marlin
model.fish.minnow	Fish Minnow
model.fish.octopus	Fish Octopus
model.fish.octopus.black	Fish Octopus Black
model.fish.perch	Fish Perch
model.fish.pike	Fish Pike
model.fish.roach	Fish Roach
model.fish.sailfish	Fish Sailfish
model.fish.sardine	Fish Sardine
model.fish.snook	Fish Snook
model.fish.trout	Fish Trout
model.fish.tuna	Fish Tuna
model.fish.whiteshark	Fish Whiteshark
model.fish.wurm	Fish Wurm
model.fishfilet	Fishfilet
model.fishing.target	Fishing Target
model.fishingreel	Fishingreel
model.fishline	Fishline
model.float.bark	Float Bark
model.float.feather	Float Feather
model.float.moss	Float Moss
model.float.twig	Float Twig
model.flower.flower1.vegetarian	Flower Flower1 Vegetarian
model.flower.flower2.vegetarian	Flower Flower2 Vegetarian
model.flower.flower3.vegetarian	Flower Flower3 Vegetarian
model.flower.flower5.vegetarian	Flower Flower5 Vegetarian
model.flower.lavender	Flower Lavender
model.flower.mixedgrass	Flower Mixedgrass
model.flower.rose	Flower Rose
model.flower.thatch.vegetarian	Flower Thatch Vegetarian
model.flower.woad	Flower Woad
model.food.apple	Food Apple
model.food.bacon	Food Bacon
model.food.biscuit	Food Biscuit
model.food.bread.sandwich	Food Bread Sandwich
model.food.butter	Food Butter
model.food.cabbage	Food Cabbage
model.food.cake	Food Cake
model.food.cake.birthday	Food Cake Birthday
model.food.cake.slice	Food Cake Slice
model.food.carrot	Food Carrot
model.food.casserole	Food Casserole
model.food.cheese	Food Cheese
model.food.cheese.feta.dairy	Food Cheese Feta Dairy
model.food.cheesecake	Food Cheesecake
model.food.cherries	Food Cherries
model.food.chestnut	Food Chestnut
model.food.chocolate	Food Chocolate
model.food.cocoa	Food Cocoa
model.food.coconut	Food Coconut
model.food.cooked	Food Cooked
model.food.cucumber	Food Cucumber
model.food.egg	Food Egg
model.food.egg.easter.vegetarian	Food Egg Easter Vegetarian
model.food.egg.large.dairy	Food Egg Large Dairy
model.food.flour	Food Flour
model.food.fries	Food Fries
model.food.grapes.blue	Food Grapes Blue
model.food.grapes.green	Food Grapes Green
model.food.haggis	Food Haggis
model.food.hazelnut	Food Hazelnut
model.food.icecream	Food Icecream
model.food.jam	Food Jam
model.food.jelly	Food Jelly
model.food.kielbasa	Food Kielbasa
model.food.lemon	Food Lemon
model.food.lettuce	Food Lettuce
model.food.meat	Food Meat
model.food.meatballs	Food Meatballs
model.food.muffin	Food Muffin
model.food.mushroom.black	Food Mushroom Black
model.food.mushroom.blue	Food Mushroom Blue
model.food.mushroom.brown	Food Mushroom Brown
model.food.mushroom.green	Food Mushroom Green
model.food.mushroom.red	Food Mushroom Red
model.food.mushroom.stuffed	Food Mushroom Stuffed
model.food.mushroom.yellow	Food Mushroom Yellow
model.food.nori	Food Nori
model.food.olives	Food Olives
model.food.omelette	Food Omelette
model.food.orange	Food Orange
model.food.pastry	Food Pastry
model.food.pasty	Food Pasty
model.food.peapod	Food Peapod
model.food.pickle	Food Pickle
model.food.pie	Food Pie
model.food.pineapple	Food Pineapple
model.food.pinenuts	Food Pinenuts
model.food.pizza	Food Pizza
model.food.potato	Food Potato
model.food.pumpkin	Food Pumpkin
model.food.pumpkin.halloween	Food Pumpkin Halloween
model.food.pumpkin.halloween.vegetarian.lit	Food Pumpkin Halloween Vegetarian Lit
model.food.rice	Food Rice
model.food.salad	Food Salad
model.food.salt	Food Salt
model.food.sausage	Food Sausage
model.food.scone	Food Scone
model.food.scrap	Food Scrap
model.food.spit.lamb	Food Spit Lamb
model.food.spit.lamb.roasted	Food Spit Lamb Roasted
model.food.spit.pig	Food Spit Pig
model.food.spit.pig.roasted	Food Spit Pig Roasted
model.food.spit.rat	Food Spit Rat
model.food.spit.rat.roasted	Food Spit Rat Roasted
model.food.steak	Food Steak
model.food.sugar	Food Sugar
model.food.sugarbeet	Food Sugarbeet
model.food.sushi	Food Sushi
model.food.sweet	Food Sweet
model.food.tart	Food Tart
model.food.tomato	Food Tomato
model.food.walnut	Food Walnut
model.fragment.birchwood	Fragment Birchwood
model.fragment.gold	Fragment Gold
model.fragment.iron	Fragment Iron
model.fragment.marble	Fragment Marble
model.fragment.pottery	Fragment Pottery
model.fragment.sandstone	Fragment Sandstone
model.fragment.stone	Fragment Stone
model.fragment.unidentified	Fragment Unidentified
model.fruit.blueberry	Fruit Blueberry
model.fruit.lingonberry	Fruit Lingonberry
model.fruit.raspberries	Fruit Raspberries
model.fruit.strawberries	Fruit Strawberries
model.furniture.bed.canopy	Furniture Bed Canopy
model.furniture.bed.canopy.unfinished	Furniture Bed Canopy Unfinished
model.furniture.bed.standard	Furniture Bed Standard
model.furniture.bed.standard.unfinished	Furniture Bed Standard Unfinished
model.furniture.bed.straw	Furniture Bed Straw
model.furniture.bedframe.standard	Furniture Bedframe Standard
model.furniture.bedframe.standard.unfinished	Furniture Bedframe Standard Unfinished
model.furniture.bench	Furniture Bench
model.furniture.bench.unfinished	Furniture Bench Unfinished
model.furniture.bowl.washing	Furniture Bowl Washing
model.furniture.bowl.washing.unfinished	Furniture Bowl Washing Unfinished
model.furniture.chair	Furniture Chair
model.furniture.chair.armchair	Furniture Chair Armchair
model.furniture.chair.lounge	Furniture Chair Lounge
model.furniture.chair.lounge.royal	Furniture Chair Lounge Royal
model.furniture.chair.unfinished	Furniture Chair Unfinished
model.furniture.coffin	Furniture Coffin
model.furniture.coffin.unfinished	Furniture Coffin Unfinished
model.furniture.footboard.standard	Furniture Footboard Standard
model.furniture.footboard.standard.unfinished	Furniture Footboard Standard Unfinished
model.furniture.headboard.standard	Furniture Headboard Standard
model.furniture.picnicbasket	Furniture Picnicbasket
model.furniture.stool.round	Furniture Stool Round
model.furniture.stool.round.unfinished	Furniture Stool Round Unfinished
model.furniture.table.round	Furniture Table Round
model.furniture.table.round.marble	Furniture Table Round Marble
model.furniture.table.round.marble.unfinished	Furniture Table Round Marble Unfinished
model.furniture.table.square.large	Furniture Table Square Large
model.furniture.table.square.large.julbord	Furniture Table Square Large Julbord
model.furniture.table.square.marble	Furniture Table Square Marble
model.furniture.table.square.small	Furniture Table Square Small
model.furniture.table.square.small.unfinished	Furniture Table Square Small Unfinished
model.furniture.tapestry	Furniture Tapestry
model.furniture.tapestry.comp3	Furniture Tapestry Comp3
model.furniture.tapestry.pattern2	Furniture Tapestry Pattern2
model.furniture.tapestry.stand.unfinished	Furniture Tapestry Stand Unfinished
model.furniture.tapestry.unfinished	Furniture Tapestry Unfinished
model.furniture.throne	Furniture Throne
model.furniture.tin.lunchbox	Furniture Tin Lunchbox
model.furniture.tripod.table	Furniture Tripod Table
model.furniture.valentineroses	Furniture Valentineroses
model.furniture.wardrobe	Furniture Wardrobe
model.furniture.wood.bench	Furniture Wood Bench
model.furniture.wood.bench.unfinished	Furniture Wood Bench Unfinished
model.furniture.wooden.bedside.table	Furniture Wooden Bedside Table
model.furniture.wooden.bedside.table.unfinished	Furniture Wooden Bedside Table Unfinished
model.furniture.wooden.coffer	Furniture Wooden Coffer
model.furniture.wooden.coffer.unfinished	Furniture Wooden Coffer Unfinished
model.furniture.wooden.cupboard	Furniture Wooden Cupboard
model.furniture.wooden.cupboard.alchemist	Furniture Wooden Cupboard Alchemist
model.furniture.wooden.larder	Furniture Wooden Larder
model.furniture.wooden.shelf	Furniture Wooden Shelf
model.furniture.wooden.storageunit	Furniture Wooden Storageunit
model.goo.red	Goo Red
model.healing.cover	Healing Cover
model.healing.salve.fat	Healing Salve Fat
model.herb.acorn	Herb Acorn
model.herb.belladonna	Herb Belladonna
model.herb.camellia	Herb Camellia
model.herb.garlic	Herb Garlic
model.herb.lovage	Herb Lovage
model.herb.mint	Herb Mint
model.herb.oleander	Herb Oleander
model.herb.onion.vegetarian	Herb Onion Vegetarian
model.herb.parsley	Herb Parsley
model.herb.rosemary	Herb Rosemary
model.herb.sage	Herb Sage
model.herb.sassafras	Herb Sassafras
model.herb.thyme	Herb Thyme
model.key	Key
model.key.lockpicks	Key Lockpicks
model.light.buoy	Light Buoy
model.light.buoy.planted	Light Buoy Planted
model.light.buoy.planted.lit	Light Buoy Planted Lit
model.light.buoy.unfinished	Light Buoy Unfinished
model.light.candle	Light Candle
model.light.lamp.street	Light Lamp Street
model.light.lamp.street.gold	Light Lamp Street Gold
model.light.lamp.street.gold.lit	Light Lamp Street Gold Lit
model.light.lamp.street.lit	Light Lamp Street Lit
model.light.lamp.street.metal.iron	Light Lamp Street Metal Iron
model.light.lamp.street.metal.iron.lit	Light Lamp Street Metal Iron Lit
model.light.lamp.street.metal.unfinished.iron	Light Lamp Street Metal Unfinished Iron
model.light.lamp.street.pole.brass	Light Lamp Street Pole Brass
model.light.lamp.street.pole.brass.lit	Light Lamp Street Pole Brass Lit
model.light.lamp.street.pole.copper	Light Lamp Street Pole Copper
model.light.lamp.street.pole.gold	Light Lamp Street Pole Gold
model.light.lamp.street.pole.iron	Light Lamp Street Pole Iron
model.light.lamp.street.pole.iron.lit	Light Lamp Street Pole Iron Lit
model.light.lamp.street.pole.silver	Light Lamp Street Pole Silver
model.light.lamp.street.pole.unfinished.brass	Light Lamp Street Pole Unfinished Brass
model.light.lamp.street.pole.unfinished.bronze	Light Lamp Street Pole Unfinished Bronze
model.light.lamp.street.pole.unfinished.copper	Light Lamp Street Pole Unfinished Copper
model.light.lamp.street.pole.unfinished.gold	Light Lamp Street Pole Unfinished Gold
model.light.lamp.street.pole.unfinished.silver	Light Lamp Street Pole Unfinished Silver
model.light.lamp.street.torch	Light Lamp Street Torch
model.light.lamp.street.torch.unfinished	Light Lamp Street Torch Unfinished
model.light.lamp.street.unfinished	Light Lamp Street Unfinished
model.light.lamp.street.unfinished.brass	Light Lamp Street Unfinished Brass
model.light.lantern.hanging.brass	Light Lantern Hanging Brass
model.light.lantern.hanging.bronze	Light Lantern Hanging Bronze
model.light.lantern.hanging.copper	Light Lantern Hanging Copper
model.light.lantern.hanging.gold	Light Lantern Hanging Gold
model.light.lantern.hanging.silver	Light Lantern Hanging Silver
model.light.lantern.hanging.unfinished.brass	Light Lantern Hanging Unfinished Brass
model.light.lantern.hanging.unfinished.bronze	Light Lantern Hanging Unfinished Bronze
model.light.lantern.hanging.unfinished.copper	Light Lantern Hanging Unfinished Copper
model.light.lantern.hanging.unfinished.gold	Light Lantern Hanging Unfinished Gold
model.light.lantern.hanging.unfinished.silver	Light Lantern Hanging Unfinished Silver
model.light.lantern.head	Light Lantern Head
model.light.lantern.head.unfinished.iron	Light Lantern Head Unfinished Iron
model.light.lantern.iron.lit	Light Lantern Iron Lit
model.light.lantern.metal.iron	Light Lantern Metal Iron
model.light.oillamp.brass	Light Oillamp Brass
model.light.snowlantern	Light Snowlantern
model.light.snowlantern.lit	Light Snowlantern Lit
model.light.token	Light Token
model.light.torch	Light Torch
model.light.torch.birchwood.lit	Light Torch Birchwood Lit
model.light.torch.metal.iron	Light Torch Metal Iron
model.light.torch.metal.unfinished.iron	Light Torch Metal Unfinished Iron
model.liquid	Liquid
model.liquid.batter	Liquid Batter
model.liquid.dairy	Liquid Dairy
model.liquid.dye.black	Liquid Dye Black
model.liquid.dye.blue	Liquid Dye Blue
model.liquid.dye.green	Liquid Dye Green
model.liquid.dye.red	Liquid Dye Red
model.liquid.dye.white	Liquid Dye White
model.liquid.sap.maple	Liquid Sap Maple
model.liquid.tannin	Liquid Tannin
model.liquid.water	Liquid Water
model.lock	Lock
model.lock.large.padlock	Lock Large Padlock
model.magic.amulet.farwalker.silver	Magic Amulet Farwalker Silver
model.magic.blood	Magic Blood
model.magic.orb.shakermagic	Magic Orb Shakermagic
model.magic.potion	Magic Potion
model.magic.potion.glass	Magic Potion Glass
model.magic.potion.yellow	Magic Potion Yellow
model.magic.wanddeity	Magic Wanddeity
model.marker.build.unfinished.birchwood	Marker Build Unfinished Birchwood
model.marker.temporary	Marker Temporary
model.marker.temporary.settle	Marker Temporary Settle
model.marker.temporary.settle.perimeter	Marker Temporary Settle Perimeter
model.minedoor.gold	Minedoor Gold
model.minedoor.silver	Minedoor Silver
model.minedoor.steel	Minedoor Steel
model.minedoor.wood	Minedoor Wood
model.mold.clay	Mold Clay
model.mold.pottery	Mold Pottery
model.part.bell.huge	Part Bell Huge
model.part.bell.huge.resonator	Part Bell Huge Resonator
model.part.blade.dredgelip.steel	Part Blade Dredgelip Steel
model.part.clapper.large	Part Clapper Large
model.part.clapper.small.iron	Part Clapper Small Iron
model.part.crowsnest	Part Crowsnest
model.part.crowsnest.unfinished	Part Crowsnest Unfinished
model.part.handle	Part Handle
model.part.ironfencebars	Part Ironfencebars
model.part.ironfencebars.unfinished	Part Ironfencebars Unfinished
model.part.keel	Part Keel
model.part.keel.part	Part Keel Part
model.part.leatherwoundhandle	Part Leatherwoundhandle
model.part.mast.tall	Part Mast Tall
model.part.oar	Part Oar
model.part.peg	Part Peg
model.part.rig.spinnaker	Part Rig Spinnaker
model.part.rig.triangular	Part Rig Triangular
model.part.rudder	Part Rudder
model.part.sail.square	Part Sail Square
model.part.seat	Part Seat
model.part.shipwheel	Part Shipwheel
model.part.small.wheel	Part Small Wheel
model.part.small.wheel.unfinished	Part Small Wheel Unfinished
model.part.small.wheelaxle	Part Small Wheelaxle
model.part.spring.steel	Part Spring Steel
model.part.stern	Part Stern
model.part.studs	Part Studs
model.part.tackle.large	Part Tackle Large
model.part.tackle.small	Part Tackle Small
model.part.tenon	Part Tenon
model.part.wires	Part Wires
model.part.yoke	Part Yoke
model.part.yoke.unfinished	Part Yoke Unfinished
model.picking.bridges	Picking Bridges
model.picking.floor	Picking Floor
model.pile.acorns	Acorns
model.pile.anchor	Anchor
model.pile.animalfat	Animalfat
model.pile.armourchains	Armourchains
model.pile.arrowshaft	Arrowshaft
model.pile.ash.charcoal	Ash Charcoal
model.pile.awl	Awl
model.pile.awlblade	Awlblade
model.pile.axe	Axe
model.pile.axehead	Axehead
model.pile.axetrap	Axetrap
model.pile.backpack	Backpack
model.pile.bacon	Bacon
model.pile.bakingstone	Bakingstone
model.pile.basinethelm	Basinethelm
model.pile.batter	Batter
model.pile.beerstein	Beerstein
model.pile.beeswax	Beeswax
model.pile.belayingpin	Belayingpin
model.pile.belladonna	Belladonna
model.pile.biscuit	Biscuit
model.pile.blackmushroom	Blackmushroom
model.pile.blackopal	Blackopal
model.pile.bladder	Bladder
model.pile.blueberry	Blueberry
model.pile.bluegrapes	Bluegrapes
model.pile.bluemushroom	Bluemushroom
model.pile.blueshark	Blueshark
model.pile.bow	Bow
model.pile.bowl.gold	Bowl Gold
model.pile.bowl.silver	Bowl Silver
model.pile.bowtrap	Bowtrap
model.pile.brandingiron	Brandingiron
model.pile.bread	Bread
model.pile.breadcrumbs	Breadcrumbs
model.pile.breastplate	Breastplate
model.pile.bridle	Bridle
model.pile.brownmushroom	Brownmushroom
model.pile.butcheringknife	Butcheringknife
model.pile.butcheringknifeblade	Butcheringknifeblade
model.pile.butter	Butter
model.pile.cabbage	Cabbage
model.pile.cabbageseed	Cabbageseed
model.pile.caketin	Caketin
model.pile.camellia	Camellia
model.pile.candle	Candle
model.pile.carp	Carp
model.pile.carrot	Carrot
model.pile.carvingknife	Carvingknife
model.pile.carvingknifeblade	Carvingknifeblade
model.pile.catfish	Catfish
model.pile.cauldron	Cauldron
model.pile.chainboot	Chainboot
model.pile.chaincoif	Chaincoif
model.pile.chaingauntlet	Chaingauntlet
model.pile.chainjacket	Chainjacket
model.pile.chainpants	Chainpants
model.pile.chainsleeve	Chainsleeve
model.pile.charcoal	Charcoal
model.pile.cheese	Cheese
model.pile.cheesecake	Cheesecake
model.pile.cheesedrill	Cheesedrill
model.pile.cherries	Cherries
model.pile.chestnut	Chestnut
model.pile.chiselblade	Chiselblade
model.pile.chocolate	Chocolate
model.pile.clay	Clay
model.pile.claybeerstein	Claybeerstein
model.pile.claybowl	Claybowl
model.pile.clayflask.clay	Clayflask Clay
model.pile.clayflowerpot.clay	Clayflowerpot Clay
model.pile.clayjar	Clayjar
model.pile.claymeasuringjug	Claymeasuringjug
model.pile.claypiedish	Claypiedish
model.pile.clayroastingdish	Clayroastingdish
model.pile.clayshaper	Clayshaper
model.pile.clayshingle.clay	Clayshingle Clay
model.pile.claysmeltingpot.clay	Claysmeltingpot Clay
model.pile.clothglove.cotton	Clothglove Cotton
model.pile.clothpants.cotton	Clothpants Cotton
model.pile.clothshoe.cotton	Clothshoe Cotton
model.pile.clothsleeve.cotton	Clothsleeve Cotton
model.pile.cochineal	Cochineal
model.pile.cocoa	Cocoa
model.pile.coconut	Coconut
model.pile.coin	Coin
model.pile.colossusbrick	Colossusbrick
model.pile.compass.iron	Compass Iron
model.pile.cookedmeat	Cookedmeat
model.pile.corn	Corn
model.pile.corndough	Corndough
model.pile.cornflour	Cornflour
model.pile.corrosivetraps	Corrosivetraps
model.pile.cotton	Cotton
model.pile.cucumber	Cucumber
model.pile.cumin	Cumin
model.pile.diamond	Diamond
model.pile.doorlock	Doorlock
model.pile.dorado	Dorado
model.pile.dough	Dough
model.pile.dragonscaleboot.leather	Dragonscaleboot Leather
model.pile.dragonscaleglove.leather	Dragonscaleglove Leather
model.pile.dragonscalepants.leather	Dragonscalepants Leather
model.pile.dragonscalesleeve.leather	Dragonscalesleeve Leather
model.pile.drakehideboot.leather	Drakehideboot Leather
model.pile.drakehideglove.leather	Drakehideglove Leather
model.pile.drakehidepants.leather	Drakehidepants Leather
model.pile.drakehidesleeve.leather	Drakehidesleeve Leather
model.pile.dredgescrapinglip	Dredgescrapinglip
model.pile.dye	Dye
model.pile.easteregg	Easteregg
model.pile.egg	Egg
model.pile.emerald	Emerald
model.pile.farmer'ssalve.fat	Farmer'ssalve Fat
model.pile.fencebars	Fencebars
model.pile.fennelplant	Fennelplant
model.pile.fetacheese.dairy	Fetacheese Dairy
model.pile.file	File
model.pile.fishfillet	Fishfillet
model.pile.fishinghook	Fishinghook
model.pile.fishingrod	Fishingrod
model.pile.flint	Flint
model.pile.flour	Flour
model.pile.footboard	Footboard
model.pile.fork	Fork
model.pile.fries	Fries
model.pile.fruitpress	Fruitpress
model.pile.fryingpan	Fryingpan
model.pile.fur.unknown	Fur Unknown
model.pile.garlic	Garlic
model.pile.gland	Gland
model.pile.glassflask.glass	Glassflask Glass
model.pile.goblinskull	Goblinskull
model.pile.greenapple	Greenapple
model.pile.greengrapes	Greengrapes
model.pile.greenmushroom	Greenmushroom
model.pile.grindstone	Grindstone
model.pile.groomingbrush	Groomingbrush
model.pile.haggis	Haggis
model.pile.halberd	Halberd
model.pile.halberdhead	Halberdhead
model.pile.hammer.iron	Hammer Iron
model.pile.hammerhead.iron	Hammerhead Iron
model.pile.handle	Handle
model.pile.hatchet	Hatchet
model.pile.hatchethead	Hatchethead
model.pile.headboard	Headboard
model.pile.healingcover	Healingcover
model.pile.herring	Herring
model.pile.hoof	Hoof
model.pile.hooks	Hooks
model.pile.hops	Hops
model.pile.huntingarrow	Huntingarrow
model.pile.huntingarrowhead	Huntingarrowhead
model.pile.icecream	Icecream
model.pile.illusionaryitem	Illusionaryitem
model.pile.jelly	Jelly
model.pile.keel	Keel
model.pile.keelsection	Keelsection
model.pile.kelp	Kelp
model.pile.key	Key
model.pile.keyform	Keyform
model.pile.keymould	Keymould
model.pile.kielbasa	Kielbasa
model.pile.kindling	Kindling
model.pile.knife	Knife
model.pile.knifetrap	Knifetrap
model.pile.label	Label
model.pile.lamphead	Lamphead
model.pile.largechain.iron	Largechain Iron
model.pile.largepadlock	Largepadlock
model.pile.leather	Leather
model.pile.leatherbelt	Leatherbelt
model.pile.leatherboot	Leatherboot
model.pile.leatherglove	Leatherglove
model.pile.leatherjacket	Leatherjacket
model.pile.leatherknife	Leatherknife
model.pile.leatherpants	Leatherpants
model.pile.leatherpieces	Leatherpieces
model.pile.leathersleeve	Leathersleeve
model.pile.leatherwoundhandle	Leatherwoundhandle
model.pile.leggat	Leggat
model.pile.lemon	Lemon
model.pile.lettuce	Lettuce
model.pile.lingonberry	Lingonberry
model.pile.lockpicks	Lockpicks
model.pile.log	Log
model.pile.longspear	Longspear
model.pile.longsword	Longsword
model.pile.longswordblade	Longswordblade
model.pile.lovage	Lovage
model.pile.lump	Lump
model.pile.lump.adamantine	Lump Adamantine
model.pile.lump.glimmersteel	Lump Glimmersteel
model.pile.mallet	Mallet
model.pile.mallethead	Mallethead
model.pile.mantrap	Mantrap
model.pile.marbleslab.marble	Marbleslab Marble
model.pile.marlin	Marlin
model.pile.maul	Maul
model.pile.maulhead	Maulhead
model.pile.meal	Meal
model.pile.measuringjug	Measuringjug
model.pile.meat	Meat
model.pile.meatballs	Meatballs
model.pile.metalbrush	Metalbrush
model.pile.metalshield	Metalshield
model.pile.mint	Mint
model.pile.mixedgrass	Mixedgrass
model.pile.mortar	Mortar
model.pile.mortarandpestle	Mortarandpestle
model.pile.moss	Moss
model.pile.muffin	Muffin
model.pile.mushroom	Mushroom
model.pile.nails	Nails
model.pile.needle	Needle
model.pile.needle.copper	Needle Copper
model.pile.nettrap	Nettrap
model.pile.nori	Nori
model.pile.oar	Oar
model.pile.oat	Oat
model.pile.octopus	Octopus
model.pile.oleander	Oleander
model.pile.olives	Olives
model.pile.omelette	Omelette
model.pile.onion	Onion
model.pile.orange	Orange
model.pile.ore.iron	Ore Iron
model.pile.papersheet	Papersheet
model.pile.papyrussheet.paper	Papyrussheet Paper
model.pile.parsley	Parsley
model.pile.pastry	Pastry
model.pile.pasty	Pasty
model.pile.paw	Paw
model.pile.pea	Pea
model.pile.peapod	Peapod
model.pile.peat	Peat
model.pile.peg	Peg
model.pile.pelt	Pelt
model.pile.perch	Perch
model.pile.pickaxe	Pickaxe
model.pile.pickaxehead.iron	Pickaxehead Iron
model.pile.pickle	Pickle
model.pile.pie	Pie
model.pile.piedish	Piedish
model.pile.pike	Pike
model.pile.pineapple	Pineapple
model.pile.pizza	Pizza
model.pile.plank	Plank
model.pile.plate	Plate
model.pile.plategauntlet	Plategauntlet
model.pile.plateleggings	Plateleggings
model.pile.platesabaton	Platesabaton
model.pile.platevambrace	Platevambrace
model.pile.poletrap	Poletrap
model.pile.potato	Potato
model.pile.potion.magic	Potion Magic
model.pile.potterybowl	Potterybowl
model.pile.potterybrick.pottery	Potterybrick Pottery
model.pile.potteryflask.pottery	Potteryflask Pottery
model.pile.potteryflowerpot.pottery	Potteryflowerpot Pottery
model.pile.potteryjar	Potteryjar
model.pile.pumpkin	Pumpkin
model.pile.quiver	Quiver
model.pile.rags.cotton	Rags Cotton
model.pile.rake	Rake
model.pile.rakeblade.iron	Rakeblade Iron
model.pile.raspberries	Raspberries
model.pile.rat-on-a-stick	Rat-on-a-stick
model.pile.redmushroom	Redmushroom
model.pile.reedfibre.reed	Reedfibre Reed
model.pile.reedplants.vegetarian	Reedplants Vegetarian
model.pile.ribbon	Ribbon
model.pile.rivets	Rivets
model.pile.roach	Roach
model.pile.roastingdish	Roastingdish
model.pile.rocksalt	Rocksalt
model.pile.rockshards	Rockshards
model.pile.rope	Rope
model.pile.ropetool	Ropetool
model.pile.ropetrap	Ropetrap
model.pile.roseflower	Roseflower
model.pile.rosemary	Rosemary
model.pile.ruby	Ruby
model.pile.rudder	Rudder
model.pile.sage	Sage
model.pile.sailfish	Sailfish
model.pile.salt	Salt
model.pile.sapphire	Sapphire
model.pile.sassafras	Sassafras
model.pile.satchel	Satchel
model.pile.saucepan	Saucepan
model.pile.sausage	Sausage
model.pile.saw	Saw
model.pile.scale.leather	Scale Leather
model.pile.scissorblade	Scissorblade
model.pile.scissors	Scissors
model.pile.scone	Scone
model.pile.scrap.iron	Scrap Iron
model.pile.scythe	Scythe
model.pile.scytheblade	Scytheblade
model.pile.scythetrap	Scythetrap
model.pile.seat	Seat
model.pile.shaft	Shaft
model.pile.shakerorb	Shakerorb
model.pile.sheet.gold	Sheet Gold
model.pile.sheet.lead	Sheet Lead
model.pile.sheet.steel	Sheet Steel
model.pile.shiphelm	Shiphelm
model.pile.shodclub	Shodclub
model.pile.shortsword	Shortsword
model.pile.shortswordblade	Shortswordblade
model.pile.shovel	Shovel
model.pile.shovelblade	Shovelblade
model.pile.sickle	Sickle
model.pile.sickleblade	Sickleblade
model.pile.skullcup	Skullcup
model.pile.slab	Slab
model.pile.slateshingle.slate	Slateshingle Slate
model.pile.sliceofbread	Sliceofbread
model.pile.smallmouthbass	Smallmouthbass
model.pile.smeltingpot.pottery	Smeltingpot Pottery
model.pile.snook	Snook
model.pile.snowball	Snowball
model.pile.spatula	Spatula
model.pile.spear	Spear
model.pile.speartip	Speartip
model.pile.spindle	Spindle
model.pile.spoon	Spoon
model.pile.spring.steel	Spring Steel
model.pile.sprout	Sprout
model.pile.squarepieceofcloth	Squarepieceofcloth
model.pile.staff	Staff
model.pile.staff.steel	Staff Steel
model.pile.stardiamond	Stardiamond
model.pile.staremerald	Staremerald
model.pile.starruby	Starruby
model.pile.starsapphire	Starsapphire
model.pile.steelandflint	Steelandflint
model.pile.sticktrap	Sticktrap
model.pile.stonebrick.unknown	Stonebrick Unknown
model.pile.stonechisel	Stonechisel
model.pile.strangebone	Strangebone
model.pile.strawberries	Strawberries
model.pile.stringofcloth	Stringofcloth
model.pile.studdedleatherboot	Studdedleatherboot
model.pile.studdedleatherglove	Studdedleatherglove
model.pile.studdedleatherjacket	Studdedleatherjacket
model.pile.studdedleatherpants	Studdedleatherpants
model.pile.studdedleathersleeve	Studdedleathersleeve
model.pile.sugar	Sugar
model.pile.sugarbeet	Sugarbeet
model.pile.supportbeam	Supportbeam
model.pile.sushi	Sushi
model.pile.sweet	Sweet
model.pile.swordblade	Swordblade
model.pile.tackle	Tackle
model.pile.tackle.small	Tackle Small
model.pile.tail	Tail
model.pile.tar	Tar
model.pile.tart	Tart
model.pile.tenon	Tenon
model.pile.thatch.vegetarian	Thatch Vegetarian
model.pile.thyme	Thyme
model.pile.toast	Toast
model.pile.tomato	Tomato
model.pile.tooth	Tooth
model.pile.triangularsail	Triangularsail
model.pile.trout	Trout
model.pile.trowel	Trowel
model.pile.trowelblade	Trowelblade
model.pile.turmeric	Turmeric
model.pile.twistedhorn	Twistedhorn
model.pile.twohandedsword	Twohandedsword
model.pile.unfinisheditem	Unfinisheditem
model.pile.unfinisheditem.cotton	Unfinisheditem Cotton
model.pile.walnut	Walnut
model.pile.waterskin	Waterskin
model.pile.waxsealingkit	Waxsealingkit
model.pile.wempfibre	Wempfibre
model.pile.wempplants	Wempplants
model.pile.wempseed.unknown	Wempseed Unknown
model.pile.wheel	Wheel
model.pile.whetstone	Whetstone
model.pile.whiteshark	Whiteshark
model.pile.wires	Wires
model.pile.woad	Woad
model.pile.woodenbeam	Woodenbeam
model.pile.woodpulp	Woodpulp
model.pile.woodscrap	Woodscrap
model.pile.woodshingle	Woodshingle
model.pile.wool	Wool
model.pile.yarn	Yarn
model.pile.yellowmushroom	Yellowmushroom
model.pile.yellowpotion.magic	Yellowpotion Magic
model.pile.yoke	Yoke
model.pile.yoyo	Yoyo
model.pileshield	Pileshield
model.planter.basil	Planter Basil
model.planter.belladonna	Planter Belladonna
model.planter.clay	Planter Clay
model.planter.cumin	Planter Cumin
model.planter.fennelplant	Planter Fennelplant
model.planter.ginger	Planter Ginger
model.planter.lovage	Planter Lovage
model.planter.mint	Planter Mint
model.planter.oregano	Planter Oregano
model.planter.paprika	Planter Paprika
model.planter.parsley	Planter Parsley
model.planter.pottery	Planter Pottery
model.planter.rosemary	Planter Rosemary
model.planter.sage	Planter Sage
model.planter.thyme	Planter Thyme
model.planter.turmeric	Planter Turmeric
model.resource.ash	Ash
model.resource.beam	Beam
model.resource.beam.hardened	Beam Hardened
model.resource.beerstein.clay	Beerstein Clay
model.resource.beerstein.pottery	Beerstein Pottery
model.resource.beeswax	Beeswax
model.resource.bladder	Bladder
model.resource.boulder.adamantine	Boulder Adamantine
model.resource.boulder.glimmersteel	Boulder Glimmersteel
model.resource.brick.colossus.stone	Brick Colossus Stone
model.resource.brick.potterypottery	Brick Potterypottery
model.resource.brick.slate	Brick Slate
model.resource.brick.stone	Brick Stone
model.resource.cabbageseeds	Cabbageseeds
model.resource.clay	Clay
model.resource.coal	Coal
model.resource.collarbone.bone	Collarbone Bone
model.resource.corn	Corn
model.resource.cotton	Cotton
model.resource.crystal	Crystal
model.resource.dirt	Dirt
model.resource.dirt.stone.equipped	Dirt Stone Equipped
model.resource.dough	Dough
model.resource.eye	Eye
model.resource.fennelplant	Fennelplant
model.resource.flint	Flint
model.resource.flour	Flour
model.resource.fur	Fur
model.resource.gland	Gland
model.resource.heart.flesh	Heart Flesh
model.resource.hoof.bone	Hoof Bone
model.resource.hops	Hops
model.resource.horn.bone	Horn Bone
model.resource.hornlong.bone	Hornlong Bone
model.resource.horntwisted	Horntwisted
model.resource.inksac	Inksac
model.resource.keystone.marble	Keystone Marble
model.resource.keystone.stone	Keystone Stone
model.resource.kindling	Kindling
model.resource.label	Label
model.resource.largechain.iron	Largechain Iron
model.resource.leather.leather	Leather Leather
model.resource.log	Log
model.resource.log.birchwood	Log Birchwood
model.resource.log.cedarwood	Log Cedarwood
model.resource.log.cherrywood	Log Cherrywood
model.resource.log.lemonwood	Log Lemonwood
model.resource.log.maplewood	Log Maplewood
model.resource.log.oakenwood	Log Oakenwood
model.resource.log.olivewood	Log Olivewood
model.resource.log.pinewood	Log Pinewood
model.resource.log.willow	Log Willow
model.resource.lump.brass	Lump Brass
model.resource.lump.copper	Lump Copper
model.resource.lump.electrum	Lump Electrum
model.resource.lump.glimmersteel	Lump Glimmersteel
model.resource.lump.gold	Lump Gold
model.resource.lump.iron	Lump Iron
model.resource.lump.lead	Lump Lead
model.resource.lump.silver	Lump Silver
model.resource.lump.steel	Lump Steel
model.resource.lump.tin	Lump Tin
model.resource.lump.zinc	Lump Zinc
model.resource.mortar	Mortar
model.resource.moss	Moss
model.resource.oat	Oat
model.resource.ore.iron	Ore Iron
model.resource.paw	Paw
model.resource.peas	Peas
model.resource.peat	Peat
model.resource.pelt.leather	Pelt Leather
model.resource.plank	Plank
model.resource.plank.applewood	Plank Applewood
model.resource.reed.vegetarian	Reed Vegetarian
model.resource.reedfibre.reed	Reedfibre Reed
model.resource.ribbon	Ribbon
model.resource.rock.iron	Rock Iron
model.resource.rocksalt	Rocksalt
model.resource.sand	Sand
model.resource.sand.stone.equipped	Sand Stone Equipped
model.resource.scales.dragon.leather	Scales Dragon Leather
model.resource.scrap	Scrap
model.resource.scrap.cotton	Scrap Cotton
model.resource.scrap.iron	Scrap Iron
model.resource.scrap.leather	Scrap Leather
model.resource.sealingkit	Sealingkit
model.resource.shaft	Shaft
model.resource.shaft.crude	Shaft Crude
model.resource.shaft.crudebirchwood	Shaft Crudebirchwood
model.resource.sheet	Sheet
model.resource.sheet.gold	Sheet Gold
model.resource.sheet.lead	Sheet Lead
model.resource.sheet.paper	Sheet Paper
model.resource.sheet.papyrus	Sheet Papyrus
model.resource.sheet.steel	Sheet Steel
model.resource.shingle	Shingle
model.resource.shingle.pottery	Shingle Pottery
model.resource.skull	Skull
model.resource.skull.human	Skull Human
model.resource.skull.mug	Skull Mug
model.resource.skull.small	Skull Small
model.resource.slab.marble	Slab Marble
model.resource.slab.stone	Slab Stone
model.resource.snowball	Snowball
model.resource.sprout	Sprout
model.resource.stone	Stone
model.resource.stone.rift	Stone Rift
model.resource.stone.swordstone	Stone Swordstone
model.resource.stone.swordstone.occupied	Stone Swordstone Occupied
model.resource.strip	Strip
model.resource.tail.leather	Tail Leather
model.resource.tallow	Tallow
model.resource.tar	Tar
model.resource.tooth.bone	Tooth Bone
model.resource.tortoise.bone	Tortoise Bone
model.resource.wemp.vegetarian	Wemp Vegetarian
model.resource.wempfibre	Wempfibre
model.resource.wemprope	Wemprope
model.resource.wempseed.vegetarian	Wempseed Vegetarian
model.resource.woodpulp.birchwood	Woodpulp Birchwood
model.resource.wool	Wool
model.resource.yard	Yard
model.resource.yarn	Yarn
model.riding.barding.cotton	Riding Barding Cotton
model.riding.barding.iron	Riding Barding Iron
model.riding.barding.leather	Riding Barding Leather
model.riding.barding.silver	Riding Barding Silver
model.riding.bit	Riding Bit
model.riding.bridle	Riding Bridle
model.riding.girth	Riding Girth
model.riding.horseshoe	Riding Horseshoe
model.riding.reins	Riding Reins
model.riding.saddle.mountbag	Riding Saddle Mountbag
model.riding.saddleseat	Riding Saddleseat
model.riding.stirrups	Riding Stirrups
model.road.catseye	Road Catseye
model.road.catseye.blind	Road Catseye Blind
model.road.link.arrow	Road Link Arrow
model.road.waystone	Road Waystone
model.road.waystone.unfinished	Road Waystone Unfinished
model.rune.fo.rift	Rune Fo Rift
model.rune.fo.rift	Rune Fo Rift
model.rune.fo.rift	Rune Fo Rift
model.rune.magranon.rift	Rune Magranon Rift
model.rune.magranon.rift	Rune Magranon Rift
model.rune.magranon.rift	Rune Magranon Rift
model.shield.large	Shield Large
model.shield.large.adamantine	Shield Large Adamantine
model.shield.large.iron	Shield Large Iron
model.shield.medium	Shield Medium
model.shield.medium.adamantine	Shield Medium Adamantine
model.shield.medium.iron	Shield Medium Iron
model.shield.small	Shield Small
model.shield.small.adamantine	Shield Small Adamantine
model.shield.small.iron	Shield Small Iron
model.shield.tortoise.bone	Shield Tortoise Bone
model.sign.gmnotice	Sign Gmnotice
model.sign.large	Sign Large
model.sign.large.unfinished	Sign Large Unfinished
model.sign.messageboard	Sign Messageboard
model.sign.pointing	Sign Pointing
model.sign.pointing.unfinished	Sign Pointing Unfinished
model.sign.recruitment	Sign Recruitment
model.sign.recruitment.unfinished	Sign Recruitment Unfinished
model.sign.shop.0	Sign Shop 0
model.sign.shop.unfinished	Sign Shop Unfinished
model.sign.small	Sign Small
model.spell.icepillar.one	Spell Icepillar One
model.spell.icepillar.two	Spell Icepillar Two
model.spell.icering	Spell Icering
model.spell.iceshard	Spell Iceshard
model.spell.mushroom.one	Spell Mushroom One
model.spell.mushroom.three	Spell Mushroom Three
model.spell.mushroom.two	Spell Mushroom Two
model.spell.shroomring	Spell Shroomring
model.spell.tentacles.one	Spell Tentacles One
model.spell.tentacles.three	Spell Tentacles Three
model.spell.tentacles.two	Spell Tentacles Two
model.spice.cumin	Spice Cumin
model.spice.turmeric	Spice Turmeric
model.structure.archerytower	Archerytower
model.structure.archerytower.unfinished	Archerytower Unfinished
model.structure.barrier.spike	Barrier Spike
model.structure.barrier.spike.unfinished	Barrier Spike Unfinished
model.structure.bellcot	Bellcot
model.structure.belltower	Belltower
model.structure.boat	Boat
model.structure.boat.caravel	Boat Caravel
model.structure.boat.caravel.unfinished	Boat Caravel Unfinished
model.structure.boat.cog	Boat Cog
model.structure.boat.cog.unfinished	Boat Cog Unfinished
model.structure.boat.corbita	Boat Corbita
model.structure.boat.corbita.unfinished	Boat Corbita Unfinished
model.structure.boat.knarr	Boat Knarr
model.structure.boat.knarr.unfinished	Boat Knarr Unfinished
model.structure.bridge.abutment.center.marble	Bridge Abutment Center Marble
model.structure.bridge.abutment.center.marble.decayed	Bridge Abutment Center Marble Decayed
model.structure.bridge.abutment.center.stone	Bridge Abutment Center Stone
model.structure.bridge.abutment.center.stone.decayed	Bridge Abutment Center Stone Decayed
model.structure.bridge.abutment.center.wood	Bridge Abutment Center Wood
model.structure.bridge.abutment.center.wood.decayed	Bridge Abutment Center Wood Decayed
model.structure.bridge.abutment.left.marble	Bridge Abutment Left Marble
model.structure.bridge.abutment.left.marble.decayed	Bridge Abutment Left Marble Decayed
model.structure.bridge.abutment.left.stone	Bridge Abutment Left Stone
model.structure.bridge.abutment.left.stone.decayed	Bridge Abutment Left Stone Decayed
model.structure.bridge.abutment.left.wood	Bridge Abutment Left Wood
model.structure.bridge.abutment.left.wood.decayed	Bridge Abutment Left Wood Decayed
model.structure.bridge.abutment.narrow.marble	Bridge Abutment Narrow Marble
model.structure.bridge.abutment.narrow.marble.decayed	Bridge Abutment Narrow Marble Decayed
model.structure.bridge.abutment.narrow.rope	Bridge Abutment Narrow Rope
model.structure.bridge.abutment.narrow.rope.decayed	Bridge Abutment Narrow Rope Decayed
model.structure.bridge.abutment.narrow.stone	Bridge Abutment Narrow Stone
model.structure.bridge.abutment.narrow.stone.decayed	Bridge Abutment Narrow Stone Decayed
model.structure.bridge.abutment.narrow.wood	Bridge Abutment Narrow Wood
model.structure.bridge.abutment.narrow.wood.decayed	Bridge Abutment Narrow Wood Decayed
model.structure.bridge.abutment.right.marble	Bridge Abutment Right Marble
model.structure.bridge.abutment.right.marble.decayed	Bridge Abutment Right Marble Decayed
model.structure.bridge.abutment.right.stone	Bridge Abutment Right Stone
model.structure.bridge.abutment.right.stone.decayed	Bridge Abutment Right Stone Decayed
model.structure.bridge.abutment.right.wood	Bridge Abutment Right Wood
model.structure.bridge.abutment.right.wood.decayed	Bridge Abutment Right Wood Decayed
model.structure.bridge.bracing.center.marble	Bridge Bracing Center Marble
model.structure.bridge.bracing.center.marble.decayed	Bridge Bracing Center Marble Decayed
model.structure.bridge.bracing.center.stone	Bridge Bracing Center Stone
model.structure.bridge.bracing.center.stone.decayed	Bridge Bracing Center Stone Decayed
model.structure.bridge.bracing.left.marble	Bridge Bracing Left Marble
model.structure.bridge.bracing.left.marble.decayed	Bridge Bracing Left Marble Decayed
model.structure.bridge.bracing.left.stone	Bridge Bracing Left Stone
model.structure.bridge.bracing.left.stone.decayed	Bridge Bracing Left Stone Decayed
model.structure.bridge.bracing.narrow.marble	Bridge Bracing Narrow Marble
model.structure.bridge.bracing.narrow.marble.decayed	Bridge Bracing Narrow Marble Decayed
model.structure.bridge.bracing.narrow.stone	Bridge Bracing Narrow Stone
model.structure.bridge.bracing.narrow.stone.decayed	Bridge Bracing Narrow Stone Decayed
model.structure.bridge.bracing.right.marble	Bridge Bracing Right Marble
model.structure.bridge.bracing.right.marble.decayed	Bridge Bracing Right Marble Decayed
model.structure.bridge.bracing.right.stone	Bridge Bracing Right Stone
model.structure.bridge.bracing.right.stone.decayed	Bridge Bracing Right Stone Decayed
model.structure.bridge.build.abutment.center.marble	Bridge Build Abutment Center Marble
model.structure.bridge.build.abutment.center.roundedstone	Bridge Build Abutment Center Roundedstone
model.structure.bridge.build.abutment.center.stone	Bridge Build Abutment Center Stone
model.structure.bridge.build.abutment.left.marble	Bridge Build Abutment Left Marble
model.structure.bridge.build.abutment.left.roundedstone	Bridge Build Abutment Left Roundedstone
model.structure.bridge.build.abutment.left.stone	Bridge Build Abutment Left Stone
model.structure.bridge.build.abutment.left.wood	Bridge Build Abutment Left Wood
model.structure.bridge.build.abutment.left.wood.decayed	Bridge Build Abutment Left Wood Decayed
model.structure.bridge.build.abutment.narrow.marble	Bridge Build Abutment Narrow Marble
model.structure.bridge.build.abutment.narrow.rope	Bridge Build Abutment Narrow Rope
model.structure.bridge.build.abutment.narrow.rope.decayed	Bridge Build Abutment Narrow Rope Decayed
model.structure.bridge.build.abutment.narrow.roundedstone	Bridge Build Abutment Narrow Roundedstone
model.structure.bridge.build.abutment.narrow.stone	Bridge Build Abutment Narrow Stone
model.structure.bridge.build.abutment.narrow.wood	Bridge Build Abutment Narrow Wood
model.structure.bridge.build.abutment.narrow.wood.decayed	Bridge Build Abutment Narrow Wood Decayed
model.structure.bridge.build.abutment.right.marble	Bridge Build Abutment Right Marble
model.structure.bridge.build.abutment.right.roundedstone	Bridge Build Abutment Right Roundedstone
model.structure.bridge.build.abutment.right.stone	Bridge Build Abutment Right Stone
model.structure.bridge.build.abutment.right.wood	Bridge Build Abutment Right Wood
model.structure.bridge.build.abutment.right.wood.decayed	Bridge Build Abutment Right Wood Decayed
model.structure.bridge.build.bracing.center.marble	Bridge Build Bracing Center Marble
model.structure.bridge.build.bracing.center.roundedstone	Bridge Build Bracing Center Roundedstone
model.structure.bridge.build.bracing.center.stone	Bridge Build Bracing Center Stone
model.structure.bridge.build.bracing.left.marble	Bridge Build Bracing Left Marble
model.structure.bridge.build.bracing.left.roundedstone	Bridge Build Bracing Left Roundedstone
model.structure.bridge.build.bracing.left.stone	Bridge Build Bracing Left Stone
model.structure.bridge.build.bracing.narrow.marble	Bridge Build Bracing Narrow Marble
model.structure.bridge.build.bracing.narrow.roundedstone	Bridge Build Bracing Narrow Roundedstone
model.structure.bridge.build.bracing.narrow.stone	Bridge Build Bracing Narrow Stone
model.structure.bridge.build.bracing.right.marble	Bridge Build Bracing Right Marble
model.structure.bridge.build.bracing.right.roundedstone	Bridge Build Bracing Right Roundedstone
model.structure.bridge.build.bracing.right.stone	Bridge Build Bracing Right Stone
model.structure.bridge.build.crown.center.marble	Bridge Build Crown Center Marble
model.structure.bridge.build.crown.center.roundedstone	Bridge Build Crown Center Roundedstone
model.structure.bridge.build.crown.center.stone	Bridge Build Crown Center Stone
model.structure.bridge.build.crown.narrow.marble	Bridge Build Crown Narrow Marble
model.structure.bridge.build.crown.narrow.rope	Bridge Build Crown Narrow Rope
model.structure.bridge.build.crown.narrow.rope.decayed	Bridge Build Crown Narrow Rope Decayed
model.structure.bridge.build.crown.narrow.roundedstone	Bridge Build Crown Narrow Roundedstone
model.structure.bridge.build.crown.narrow.stone	Bridge Build Crown Narrow Stone
model.structure.bridge.build.crown.narrow.wood	Bridge Build Crown Narrow Wood
model.structure.bridge.build.crown.narrow.wood.decayed	Bridge Build Crown Narrow Wood Decayed
model.structure.bridge.build.crown.side.marble	Bridge Build Crown Side Marble
model.structure.bridge.build.crown.side.roundedstone	Bridge Build Crown Side Roundedstone
model.structure.bridge.build.crown.side.stone	Bridge Build Crown Side Stone
model.structure.bridge.build.crown.side.wood	Bridge Build Crown Side Wood
model.structure.bridge.build.crown.side.wood.decayed	Bridge Build Crown Side Wood Decayed
model.structure.bridge.build.double.center.marble	Bridge Build Double Center Marble
model.structure.bridge.build.double.center.roundedstone	Bridge Build Double Center Roundedstone
model.structure.bridge.build.double.center.stone	Bridge Build Double Center Stone
model.structure.bridge.build.double.narrow.marble	Bridge Build Double Narrow Marble
model.structure.bridge.build.double.narrow.roundedstone	Bridge Build Double Narrow Roundedstone
model.structure.bridge.build.double.narrow.stone	Bridge Build Double Narrow Stone
model.structure.bridge.build.double.side.marble	Bridge Build Double Side Marble
model.structure.bridge.build.double.side.roundedstone	Bridge Build Double Side Roundedstone
model.structure.bridge.build.double.side.stone	Bridge Build Double Side Stone
model.structure.bridge.build.end.center.marble	Bridge Build End Center Marble
model.structure.bridge.build.end.center.roundedstone	Bridge Build End Center Roundedstone
model.structure.bridge.build.end.center.stone	Bridge Build End Center Stone
model.structure.bridge.build.end.narrow.marble	Bridge Build End Narrow Marble
model.structure.bridge.build.end.narrow.rope	Bridge Build End Narrow Rope
model.structure.bridge.build.end.narrow.rope.decayed	Bridge Build End Narrow Rope Decayed
model.structure.bridge.build.end.narrow.roundedstone	Bridge Build End Narrow Roundedstone
model.structure.bridge.build.end.narrow.stone	Bridge Build End Narrow Stone
model.structure.bridge.build.end.side.marble	Bridge Build End Side Marble
model.structure.bridge.build.end.side.roundedstone	Bridge Build End Side Roundedstone
model.structure.bridge.build.end.side.stone	Bridge Build End Side Stone
model.structure.bridge.build.extension.center.marble	Bridge Build Extension Center Marble
model.structure.bridge.build.extension.center.stone	Bridge Build Extension Center Stone
model.structure.bridge.build.extension.narrow.marble	Bridge Build Extension Narrow Marble
model.structure.bridge.build.extension.narrow.roundedstone	Bridge Build Extension Narrow Roundedstone
model.structure.bridge.build.extension.narrow.stone	Bridge Build Extension Narrow Stone
model.structure.bridge.build.extension.narrow.wood.decayed	Bridge Build Extension Narrow Wood Decayed
model.structure.bridge.build.extension.side.marble	Bridge Build Extension Side Marble
model.structure.bridge.build.extension.side.stone	Bridge Build Extension Side Stone
model.structure.bridge.build.floating.center.marble	Bridge Build Floating Center Marble
model.structure.bridge.build.floating.center.roundedstone	Bridge Build Floating Center Roundedstone
model.structure.bridge.build.floating.center.stone	Bridge Build Floating Center Stone
model.structure.bridge.build.floating.narrow.marble	Bridge Build Floating Narrow Marble
model.structure.bridge.build.floating.narrow.roundedstone	Bridge Build Floating Narrow Roundedstone
model.structure.bridge.build.floating.narrow.stone	Bridge Build Floating Narrow Stone
model.structure.bridge.build.floating.side.marble	Bridge Build Floating Side Marble
model.structure.bridge.build.floating.side.roundedstone	Bridge Build Floating Side Roundedstone
model.structure.bridge.build.floating.side.stone	Bridge Build Floating Side Stone
model.structure.bridge.build.support.center.marble	Bridge Build Support Center Marble
model.structure.bridge.build.support.center.roundedstone	Bridge Build Support Center Roundedstone
model.structure.bridge.build.support.center.stone	Bridge Build Support Center Stone
model.structure.bridge.build.support.narrow.marble	Bridge Build Support Narrow Marble
model.structure.bridge.build.support.narrow.roundedstone	Bridge Build Support Narrow Roundedstone
model.structure.bridge.build.support.narrow.stone	Bridge Build Support Narrow Stone
model.structure.bridge.build.support.narrow.wood	Bridge Build Support Narrow Wood
model.structure.bridge.build.support.narrow.wood.decayed	Bridge Build Support Narrow Wood Decayed
model.structure.bridge.build.support.side.marble	Bridge Build Support Side Marble
model.structure.bridge.build.support.side.roundedstone	Bridge Build Support Side Roundedstone
model.structure.bridge.build.support.side.stone	Bridge Build Support Side Stone
model.structure.bridge.build.support.side.wood	Bridge Build Support Side Wood
model.structure.bridge.build.support.side.wood.decayed	Bridge Build Support Side Wood Decayed
model.structure.bridge.crown.center.marble	Bridge Crown Center Marble
model.structure.bridge.crown.center.marble.decayed	Bridge Crown Center Marble Decayed
model.structure.bridge.crown.center.stone	Bridge Crown Center Stone
model.structure.bridge.crown.center.stone.decayed	Bridge Crown Center Stone Decayed
model.structure.bridge.crown.center.wood	Bridge Crown Center Wood
model.structure.bridge.crown.center.wood.decayed	Bridge Crown Center Wood Decayed
model.structure.bridge.crown.narrow.marble	Bridge Crown Narrow Marble
model.structure.bridge.crown.narrow.marble.decayed	Bridge Crown Narrow Marble Decayed
model.structure.bridge.crown.narrow.rope	Bridge Crown Narrow Rope
model.structure.bridge.crown.narrow.rope.decayed	Bridge Crown Narrow Rope Decayed
model.structure.bridge.crown.narrow.stone	Bridge Crown Narrow Stone
model.structure.bridge.crown.narrow.stone.decayed	Bridge Crown Narrow Stone Decayed
model.structure.bridge.crown.narrow.wood	Bridge Crown Narrow Wood
model.structure.bridge.crown.narrow.wood.decayed	Bridge Crown Narrow Wood Decayed
model.structure.bridge.crown.side.marble	Bridge Crown Side Marble
model.structure.bridge.crown.side.marble.decayed	Bridge Crown Side Marble Decayed
model.structure.bridge.crown.side.stone	Bridge Crown Side Stone
model.structure.bridge.crown.side.stone.decayed	Bridge Crown Side Stone Decayed
model.structure.bridge.crown.side.wood	Bridge Crown Side Wood
model.structure.bridge.crown.side.wood.decayed	Bridge Crown Side Wood Decayed
model.structure.bridge.double.center.marble	Bridge Double Center Marble
model.structure.bridge.double.center.marble.decayed	Bridge Double Center Marble Decayed
model.structure.bridge.double.center.stone	Bridge Double Center Stone
model.structure.bridge.double.center.stone.decayed	Bridge Double Center Stone Decayed
model.structure.bridge.double.narrow.marble	Bridge Double Narrow Marble
model.structure.bridge.double.narrow.marble.decayed	Bridge Double Narrow Marble Decayed
model.structure.bridge.double.narrow.stone	Bridge Double Narrow Stone
model.structure.bridge.double.narrow.stone.decayed	Bridge Double Narrow Stone Decayed
model.structure.bridge.double.side.marble	Bridge Double Side Marble
model.structure.bridge.double.side.marble.decayed	Bridge Double Side Marble Decayed
model.structure.bridge.double.side.stone	Bridge Double Side Stone
model.structure.bridge.double.side.stone.decayed	Bridge Double Side Stone Decayed
model.structure.bridge.end.center.marble	Bridge End Center Marble
model.structure.bridge.end.center.marble.decayed	Bridge End Center Marble Decayed
model.structure.bridge.end.center.stone	Bridge End Center Stone
model.structure.bridge.end.center.stone.decayed	Bridge End Center Stone Decayed
model.structure.bridge.end.narrow.marble	Bridge End Narrow Marble
model.structure.bridge.end.narrow.marble.decayed	Bridge End Narrow Marble Decayed
model.structure.bridge.end.narrow.rope	Bridge End Narrow Rope
model.structure.bridge.end.narrow.rope.decayed	Bridge End Narrow Rope Decayed
model.structure.bridge.end.narrow.stone	Bridge End Narrow Stone
model.structure.bridge.end.narrow.stone.decayed	Bridge End Narrow Stone Decayed
model.structure.bridge.end.side.marble	Bridge End Side Marble
model.structure.bridge.end.side.marble.decayed	Bridge End Side Marble Decayed
model.structure.bridge.end.side.stone	Bridge End Side Stone
model.structure.bridge.end.side.stone.decayed	Bridge End Side Stone Decayed
model.structure.bridge.extension.center.marble.decayed	Bridge Extension Center Marble Decayed
model.structure.bridge.extension.center.stone.decayed	Bridge Extension Center Stone Decayed
model.structure.bridge.extension.narrow.marble.decayed	Bridge Extension Narrow Marble Decayed
model.structure.bridge.extension.narrow.stone.decayed	Bridge Extension Narrow Stone Decayed
model.structure.bridge.extension.side.marble.decayed	Bridge Extension Side Marble Decayed
model.structure.bridge.extension.side.stone.decayed	Bridge Extension Side Stone Decayed
model.structure.bridge.floating.center.marble	Bridge Floating Center Marble
model.structure.bridge.floating.center.marble.decayed	Bridge Floating Center Marble Decayed
model.structure.bridge.floating.center.stone	Bridge Floating Center Stone
model.structure.bridge.floating.center.stone.decayed	Bridge Floating Center Stone Decayed
model.structure.bridge.floating.narrow.marble	Bridge Floating Narrow Marble
model.structure.bridge.floating.narrow.marble.decayed	Bridge Floating Narrow Marble Decayed
model.structure.bridge.floating.narrow.stone	Bridge Floating Narrow Stone
model.structure.bridge.floating.narrow.stone.decayed	Bridge Floating Narrow Stone Decayed
model.structure.bridge.floating.side.marble	Bridge Floating Side Marble
model.structure.bridge.floating.side.marble.decayed	Bridge Floating Side Marble Decayed
model.structure.bridge.floating.side.stone	Bridge Floating Side Stone
model.structure.bridge.floating.side.stone.decayed	Bridge Floating Side Stone Decayed
model.structure.bridge.plan.abutment.narrow	Bridge Plan Abutment Narrow
model.structure.bridge.plan.abutment.narrow.rope	Bridge Plan Abutment Narrow Rope
model.structure.bridge.plan.abutment.narrow.wood	Bridge Plan Abutment Narrow Wood
model.structure.bridge.plan.abutment.right.wood	Bridge Plan Abutment Right Wood
model.structure.bridge.plan.bracing.narrow	Bridge Plan Bracing Narrow
model.structure.bridge.plan.crown.narrow	Bridge Plan Crown Narrow
model.structure.bridge.plan.crown.narrow.rope	Bridge Plan Crown Narrow Rope
model.structure.bridge.plan.crown.narrow.wood	Bridge Plan Crown Narrow Wood
model.structure.bridge.plan.crown.side.wood	Bridge Plan Crown Side Wood
model.structure.bridge.plan.double.narrow	Bridge Plan Double Narrow
model.structure.bridge.plan.end.narrow	Bridge Plan End Narrow
model.structure.bridge.plan.end.narrow.rope	Bridge Plan End Narrow Rope
model.structure.bridge.plan.extension.narrow	Bridge Plan Extension Narrow
model.structure.bridge.plan.extension.narrow.wood	Bridge Plan Extension Narrow Wood
model.structure.bridge.plan.support.narrow	Bridge Plan Support Narrow
model.structure.bridge.plan.support.narrow.wood	Bridge Plan Support Narrow Wood
model.structure.bridge.plan.support.side.wood	Bridge Plan Support Side Wood
model.structure.bridge.support.center.marble	Bridge Support Center Marble
model.structure.bridge.support.center.marble.decayed	Bridge Support Center Marble Decayed
model.structure.bridge.support.center.stone	Bridge Support Center Stone
model.structure.bridge.support.center.stone.decayed	Bridge Support Center Stone Decayed
model.structure.bridge.support.center.wood	Bridge Support Center Wood
model.structure.bridge.support.center.wood.decayed	Bridge Support Center Wood Decayed
model.structure.bridge.support.narrow.marble	Bridge Support Narrow Marble
model.structure.bridge.support.narrow.marble.decayed	Bridge Support Narrow Marble Decayed
model.structure.bridge.support.narrow.stone	Bridge Support Narrow Stone
model.structure.bridge.support.narrow.stone.decayed	Bridge Support Narrow Stone Decayed
model.structure.bridge.support.narrow.wood	Bridge Support Narrow Wood
model.structure.bridge.support.narrow.wood.decayed	Bridge Support Narrow Wood Decayed
model.structure.bridge.support.side.marble	Bridge Support Side Marble
model.structure.bridge.support.side.marble.decayed	Bridge Support Side Marble Decayed
model.structure.bridge.support.side.stone	Bridge Support Side Stone
model.structure.bridge.support.side.stone.decayed	Bridge Support Side Stone Decayed
model.structure.bridge.support.side.wood	Bridge Support Side Wood
model.structure.bridge.support.side.wood.decayed	Bridge Support Side Wood Decayed
model.structure.captureflag	Captureflag
model.structure.captureflag.hots	Captureflag Hots
model.structure.capturetower	Capturetower
model.structure.den	Den
model.structure.den.dog	Den Dog
model.structure.den.goblin	Den Goblin
model.structure.duelring.corner.stone	Duelring Corner Stone
model.structure.duelring.corner.stone.jenn	Duelring Corner Stone Jenn
model.structure.duelring.side.stone	Duelring Side Stone
model.structure.duelring.stone	Duelring Stone
model.structure.duelring.stone.jenn	Duelring Stone Jenn
model.structure.floor.opening	Floor Opening
model.structure.floor.opening.plan	Floor Opening Plan
model.structure.floor.opening.plan.standalone	Floor Opening Plan Standalone
model.structure.floor.opening.stone_brick	Floor Opening Stone_brick
model.structure.floor.plan	Floor Plan
model.structure.floor.stone_brick	Floor Stone_brick
model.structure.floor.wood	Floor Wood
model.structure.floorboards	Floorboards
model.structure.guardtower.free.stone	Guardtower Free Stone
model.structure.guardtower.free.unfinished.stone	Guardtower Free Unfinished Stone
model.structure.guardtower.hots.stone	Guardtower Hots Stone
model.structure.guardtower.hots.unfinished	Guardtower Hots Unfinished
model.structure.guardtower.jenn.stone	Guardtower Jenn Stone
model.structure.guardtower.jenn.unfinished.stone	Guardtower Jenn Unfinished Stone
model.structure.guardtower.molr.stone	Guardtower Molr Stone
model.structure.guardtower.molr.unfinished.stone	Guardtower Molr Unfinished Stone
model.structure.invismantletfence	Invismantletfence
model.structure.joists	Joists
model.structure.joists.unfinished	Joists Unfinished
model.structure.large.cart	Large Cart
model.structure.large.cart.unfinished	Large Cart Unfinished
model.structure.marketstall	Marketstall
model.structure.marketstall.empty	Marketstall Empty
model.structure.marketstall.unfinished	Marketstall Unfinished
model.structure.minedoor	Minedoor
model.structure.minedoor.gold	Minedoor Gold
model.structure.minedoor.silver	Minedoor Silver
model.structure.minedoor.steel	Minedoor Steel
model.structure.minedoor.wood	Minedoor Wood
model.structure.neutraltower	Neutraltower
model.structure.obelisque	Obelisque
model.structure.obelisque.unfinished	Obelisque Unfinished
model.structure.pillar	Pillar
model.structure.pillar.foundationstone	Pillar Foundationstone
model.structure.pillar.foundationunfinished.stone	Pillar Foundationunfinished Stone
model.structure.pillar.unfinished.stone	Pillar Unfinished Stone
model.structure.portal.1	Portal 1
model.structure.portal.10.stone	Portal 10 Stone
model.structure.portal.3	Portal 3
model.structure.portal.7	Portal 7
model.structure.portal.8	Portal 8
model.structure.portal.8.unfinished	Portal 8 Unfinished
model.structure.portal.9	Portal 9
model.structure.pylon	Pylon
model.structure.pylon.unfinished	Pylon Unfinished
model.structure.rift.altar.1	Rift Altar 1
model.structure.rift.crystal.1	Rift Crystal 1
model.structure.rift.crystal.2	Rift Crystal 2
model.structure.rift.crystal.3	Rift Crystal 3
model.structure.rift.crystal.4	Rift Crystal 4
model.structure.rift.plant.1	Rift Plant 1
model.structure.rift.plant.2	Rift Plant 2
model.structure.rift.plant.3	Rift Plant 3
model.structure.rift.plant.4	Rift Plant 4
model.structure.rift.stone.1	Rift Stone 1
model.structure.rift.stone.2	Rift Stone 2
model.structure.rift.stone.3	Rift Stone 3
model.structure.rift.stone.4	Rift Stone 4
model.structure.roof.clay_brick.1	Roof Clay_brick 1
model.structure.roof.clay_brick.10	Roof Clay_brick 10
model.structure.roof.clay_brick.11	Roof Clay_brick 11
model.structure.roof.clay_brick.12	Roof Clay_brick 12
model.structure.roof.clay_brick.13	Roof Clay_brick 13
model.structure.roof.clay_brick.14	Roof Clay_brick 14
model.structure.roof.clay_brick.15	Roof Clay_brick 15
model.structure.roof.clay_brick.2	Roof Clay_brick 2
model.structure.roof.clay_brick.4	Roof Clay_brick 4
model.structure.roof.clay_brick.5	Roof Clay_brick 5
model.structure.roof.clay_brick.6	Roof Clay_brick 6
model.structure.roof.clay_brick.7	Roof Clay_brick 7
model.structure.roof.clay_brick.8	Roof Clay_brick 8
model.structure.roof.clay_brick.9	Roof Clay_brick 9
model.structure.roof.wood.1	Roof Wood 1
model.structure.roof.wood.10	Roof Wood 10
model.structure.roof.wood.11	Roof Wood 11
model.structure.roof.wood.12	Roof Wood 12
model.structure.roof.wood.13	Roof Wood 13
model.structure.roof.wood.14	Roof Wood 14
model.structure.roof.wood.15	Roof Wood 15
model.structure.roof.wood.2	Roof Wood 2
model.structure.roof.wood.4	Roof Wood 4
model.structure.roof.wood.5	Roof Wood 5
model.structure.roof.wood.6	Roof Wood 6
model.structure.roof.wood.7	Roof Wood 7
model.structure.roof.wood.8	Roof Wood 8
model.structure.roof.wood.9	Roof Wood 9
model.structure.shrine	Shrine
model.structure.shrine.unfinished.unknown	Shrine Unfinished Unknown
model.structure.siegeshield	Siegeshield
model.structure.siegeshield.unfinished	Siegeshield Unfinished
model.structure.small.ballista	Small Ballista
model.structure.small.ballista.unfinished	Small Ballista Unfinished
model.structure.small.batteringram	Small Batteringram
model.structure.small.batteringram.unfinished	Small Batteringram Unfinished
model.structure.small.boat.rowing	Small Boat Rowing
model.structure.small.boat.rowing.unfinished	Small Boat Rowing Unfinished
model.structure.small.boat.sailing	Small Boat Sailing
model.structure.small.boat.sailing.unfinished	Small Boat Sailing Unfinished
model.structure.small.cart	Small Cart
model.structure.small.cart.unfinished	Small Cart Unfinished
model.structure.small.catapult	Small Catapult
model.structure.small.catapult.unfinished	Small Catapult Unfinished
model.structure.small.mount	Small Mount
model.structure.small.pewpewdie.acid	Small Pewpewdie Acid
model.structure.small.pewpewdie.fire	Small Pewpewdie Fire
model.structure.small.pewpewdie.frost	Small Pewpewdie Frost
model.structure.small.pewpewdie.lightning	Small Pewpewdie Lightning
model.structure.small.pewpewdie.uncharged	Small Pewpewdie Uncharged
model.structure.small.pewpewdie.unfinished	Small Pewpewdie Unfinished
model.structure.small.raft	Small Raft
model.structure.small.raft.unfinished	Small Raft Unfinished
model.structure.small.trebuchet	Small Trebuchet
model.structure.small.trebuchet.unfinished	Small Trebuchet Unfinished
model.structure.spiritgate	Spiritgate
model.structure.spiritgate.unfinished	Spiritgate Unfinished
model.structure.staircase.anticlockwise.none	Staircase Anticlockwise None
model.structure.staircase.anticlockwise.with	Staircase Anticlockwise With
model.structure.staircase.clockwise.none	Staircase Clockwise None
model.structure.staircase.clockwise.none.plan	Staircase Clockwise None Plan
model.structure.staircase.clockwise.with	Staircase Clockwise With
model.structure.staircase.left.standalone	Staircase Left Standalone
model.structure.staircase.left.stone_brick	Staircase Left Stone_brick
model.structure.staircase.left.wood	Staircase Left Wood
model.structure.staircase.plan	Staircase Plan
model.structure.staircase.right.standalone	Staircase Right Standalone
model.structure.staircase.right.stone_brick	Staircase Right Stone_brick
model.structure.staircase.right.wood	Staircase Right Wood
model.structure.staircase.standalone	Staircase Standalone
model.structure.staircase.standalone.decayed	Staircase Standalone Decayed
model.structure.staircase.stone_brick	Staircase Stone_brick
model.structure.staircase.stone_slab	Staircase Stone_slab
model.structure.staircase.wide.both	Staircase Wide Both
model.structure.staircase.wide.left	Staircase Wide Left
model.structure.staircase.wide.none	Staircase Wide None
model.structure.staircase.wide.plan	Staircase Wide Plan
model.structure.staircase.wide.right	Staircase Wide Right
model.structure.staircase.wood	Staircase Wood
model.structure.staircase.wood.decayed	Staircase Wood Decayed
model.structure.tent.military	Tent Military
model.structure.tent.military.cotton	Tent Military Cotton
model.structure.tent.military.cotton.molr	Tent Military Cotton Molr
model.structure.tent.military.unfinished	Tent Military Unfinished
model.structure.tent.pavilion	Tent Pavilion
model.structure.tent.pavilion.cotton.molr	Tent Pavilion Cotton Molr
model.structure.tent.small	Tent Small
model.structure.tent.small.cotton.equipped	Tent Small Cotton Equipped
model.structure.tent.small.unfinished	Tent Small Unfinished
model.structure.tent.small.wagoner	Tent Small Wagoner
model.structure.wall	Wall
model.structure.wall.fence.chains	Wall Fence Chains
model.structure.wall.fence.chains.pottery	Wall Fence Chains Pottery
model.structure.wall.fence.crude	Wall Fence Crude
model.structure.wall.fence.crude.decayed	Wall Fence Crude Decayed
model.structure.wall.fence.crude.plan	Wall Fence Crude Plan
model.structure.wall.fence.curb	Wall Fence Curb
model.structure.wall.fence.curb.decayed	Wall Fence Curb Decayed
model.structure.wall.fence.fence.decayed	Wall Fence Fence Decayed
model.structure.wall.fence.garde.high	Wall Fence Garde High
model.structure.wall.fence.garde.high.decayed	Wall Fence Garde High Decayed
model.structure.wall.fence.garde.low	Wall Fence Garde Low
model.structure.wall.fence.garde.low.decayed	Wall Fence Garde Low Decayed
model.structure.wall.fence.gate.crude	Wall Fence Gate Crude
model.structure.wall.fence.gate.crude.decayed	Wall Fence Gate Crude Decayed
model.structure.wall.fence.gate.fence	Wall Fence Gate Fence
model.structure.wall.fence.gate.fence.decayed	Wall Fence Gate Fence Decayed
model.structure.wall.fence.gate.garde	Wall Fence Gate Garde
model.structure.wall.fence.gate.garde.decayed	Wall Fence Gate Garde Decayed
model.structure.wall.fence.gate.iron	Wall Fence Gate Iron
model.structure.wall.fence.gate.iron.decayed	Wall Fence Gate Iron Decayed
model.structure.wall.fence.gate.iron.high	Wall Fence Gate Iron High
model.structure.wall.fence.gate.iron.high.pottery	Wall Fence Gate Iron High Pottery
model.structure.wall.fence.gate.palisade	Wall Fence Gate Palisade
model.structure.wall.fence.gate.palisade.decayed	Wall Fence Gate Palisade Decayed
model.structure.wall.fence.iron	Wall Fence Iron
model.structure.wall.fence.iron.decayed	Wall Fence Iron Decayed
model.structure.wall.fence.iron.high	Wall Fence Iron High
model.structure.wall.fence.iron.high.pottery	Wall Fence Iron High Pottery
model.structure.wall.fence.magic.fire	Wall Fence Magic Fire
model.structure.wall.fence.magic.ice	Wall Fence Magic Ice
model.structure.wall.fence.magic.stone	Wall Fence Magic Stone
model.structure.wall.fence.palisade	Wall Fence Palisade
model.structure.wall.fence.palisade.decayed	Wall Fence Palisade Decayed
model.structure.wall.fence.parapet.pottery	Wall Fence Parapet Pottery
model.structure.wall.fence.parapet.stone	Wall Fence Parapet Stone
model.structure.wall.fence.parapet.stoneiron	Wall Fence Parapet Stoneiron
model.structure.wall.fence.parapet.wooden	Wall Fence Parapet Wooden
model.structure.wall.fence.plan.chains	Wall Fence Plan Chains
model.structure.wall.fence.plan.chains.pottery	Wall Fence Plan Chains Pottery
model.structure.wall.fence.plan.curb	Wall Fence Plan Curb
model.structure.wall.fence.plan.fence	Wall Fence Plan Fence
model.structure.wall.fence.plan.fence.decayed	Wall Fence Plan Fence Decayed
model.structure.wall.fence.plan.garde.gate	Wall Fence Plan Garde Gate
model.structure.wall.fence.plan.garde.high	Wall Fence Plan Garde High
model.structure.wall.fence.plan.garde.low	Wall Fence Plan Garde Low
model.structure.wall.fence.plan.gate.iron	Wall Fence Plan Gate Iron
model.structure.wall.fence.plan.gate.iron.high	Wall Fence Plan Gate Iron High
model.structure.wall.fence.plan.gate.iron.high.pottery	Wall Fence Plan Gate Iron High Pottery
model.structure.wall.fence.plan.gate.palisade	Wall Fence Plan Gate Palisade
model.structure.wall.fence.plan.iron	Wall Fence Plan Iron
model.structure.wall.fence.plan.iron.high	Wall Fence Plan Iron High
model.structure.wall.fence.plan.iron.high.pottery	Wall Fence Plan Iron High Pottery
model.structure.wall.fence.plan.iron.slate	Wall Fence Plan Iron Slate
model.structure.wall.fence.plan.palisade	Wall Fence Plan Palisade
model.structure.wall.fence.plan.parapet.pottery	Wall Fence Plan Parapet Pottery
model.structure.wall.fence.plan.parapet.stone	Wall Fence Plan Parapet Stone
model.structure.wall.fence.plan.parapet.stoneiron	Wall Fence Plan Parapet Stoneiron
model.structure.wall.fence.plan.parapet.wooden	Wall Fence Plan Parapet Wooden
model.structure.wall.fence.plan.rope.high	Wall Fence Plan Rope High
model.structure.wall.fence.plan.slate	Wall Fence Plan Slate
model.structure.wall.fence.plan.stone	Wall Fence Plan Stone
model.structure.wall.fence.plan.stonewall.short	Wall Fence Plan Stonewall Short
model.structure.wall.fence.plan.stonewall.tall	Wall Fence Plan Stonewall Tall
model.structure.wall.fence.plan.stonewall.tall.pottery	Wall Fence Plan Stonewall Tall Pottery
model.structure.wall.fence.plan.woven	Wall Fence Plan Woven
model.structure.wall.fence.rope.high	Wall Fence Rope High
model.structure.wall.fence.rope.high.decayed	Wall Fence Rope High Decayed
model.structure.wall.fence.rope.low	Wall Fence Rope Low
model.structure.wall.fence.rope.low.decayed	Wall Fence Rope Low Decayed
model.structure.wall.fence.stone	Wall Fence Stone
model.structure.wall.fence.stone.decayed	Wall Fence Stone Decayed
model.structure.wall.fence.stonewall.short	Wall Fence Stonewall Short
model.structure.wall.fence.stonewall.short.decayed	Wall Fence Stonewall Short Decayed
model.structure.wall.fence.stonewall.tall	Wall Fence Stonewall Tall
model.structure.wall.fence.stonewall.tall.decayed	Wall Fence Stonewall Tall Decayed
model.structure.wall.fence.stonewall.tall.pottery	Wall Fence Stonewall Tall Pottery
model.structure.wall.fence.stonewall.tall.pottery.decayed	Wall Fence Stonewall Tall Pottery Decayed
model.structure.wall.fence.stonewallPortcullis	Wall Fence StonewallPortcullis
model.structure.wall.fence.stonewallPortcullis.pottery	Wall Fence StonewallPortcullis Pottery
model.structure.wall.fence.woven	Wall Fence Woven
model.structure.wall.fence.woven.decayed	Wall Fence Woven Decayed
model.structure.wall.flowerbed.blue	Wall Flowerbed Blue
model.structure.wall.flowerbed.greenish	Wall Flowerbed Greenish
model.structure.wall.flowerbed.orange	Wall Flowerbed Orange
model.structure.wall.flowerbed.purple	Wall Flowerbed Purple
model.structure.wall.flowerbed.white	Wall Flowerbed White
model.structure.wall.flowerbed.white.dotted	Wall Flowerbed White Dotted
model.structure.wall.flowerbed.yellow	Wall Flowerbed Yellow
model.structure.wall.hedge.1.high.wintermodel.structure.wall.hedge.2.low	Wall Hedge 1 High Wintermodel Structure Wall Hedge 2 Low
model.structure.wall.hedge.1.low	Wall Hedge 1 Low
model.structure.wall.hedge.1.low.winter	Wall Hedge 1 Low Winter
model.structure.wall.hedge.2.high	Wall Hedge 2 High
model.structure.wall.hedge.2.high.winter	Wall Hedge 2 High Winter
model.structure.wall.hedge.2.low.winter	Wall Hedge 2 Low Winter
model.structure.wall.hedge.2.medium	Wall Hedge 2 Medium
model.structure.wall.hedge.2.medium.winter	Wall Hedge 2 Medium Winter
model.structure.wall.hedge.3.low	Wall Hedge 3 Low
model.structure.wall.hedge.3.low.winter	Wall Hedge 3 Low Winter
model.structure.wall.hedge.3.medium	Wall Hedge 3 Medium
model.structure.wall.hedge.3.medium.winter	Wall Hedge 3 Medium Winter
model.structure.wall.hedge.4.high	Wall Hedge 4 High
model.structure.wall.hedge.4.high.winter	Wall Hedge 4 High Winter
model.structure.wall.hedge.4.low	Wall Hedge 4 Low
model.structure.wall.hedge.4.low.winter	Wall Hedge 4 Low Winter
model.structure.wall.hedge.4.medium	Wall Hedge 4 Medium
model.structure.wall.hedge.4.medium.winter	Wall Hedge 4 Medium Winter
model.structure.wall.hedge.5.high	Wall Hedge 5 High
model.structure.wall.hedge.5.high.winter	Wall Hedge 5 High Winter
model.structure.wall.hedge.5.low	Wall Hedge 5 Low
model.structure.wall.hedge.5.low.winter	Wall Hedge 5 Low Winter
model.structure.wall.hedge.5.medium	Wall Hedge 5 Medium
model.structure.wall.hedge.5.medium.winter	Wall Hedge 5 Medium Winter
model.structure.wall.hedge.6.high	Wall Hedge 6 High
model.structure.wall.hedge.6.high.winter	Wall Hedge 6 High Winter
model.structure.wall.hedge.6.low	Wall Hedge 6 Low
model.structure.wall.hedge.6.low.winter	Wall Hedge 6 Low Winter
model.structure.wall.hedge.6.medium	Wall Hedge 6 Medium
model.structure.wall.hedge.6.medium.winter	Wall Hedge 6 Medium Winter
model.structure.wall.hedge.7.high	Wall Hedge 7 High
model.structure.wall.hedge.7.high.winter	Wall Hedge 7 High Winter
model.structure.wall.hedge.7.low	Wall Hedge 7 Low
model.structure.wall.hedge.7.low.winter	Wall Hedge 7 Low Winter
model.structure.wall.hedge.7.medium	Wall Hedge 7 Medium
model.structure.wall.hedge.7.medium.winter	Wall Hedge 7 Medium Winter
model.structure.wall.house	Wall House
model.structure.wall.house.arched.stone	Wall House Arched Stone
model.structure.wall.house.arched.stone.decayed	Wall House Arched Stone Decayed
model.structure.wall.house.arched.stone.upper	Wall House Arched Stone Upper
model.structure.wall.house.arched.stone.upper.decayed	Wall House Arched Stone Upper Decayed
model.structure.wall.house.arched.stoneplain	Wall House Arched Stoneplain
model.structure.wall.house.arched.stoneplain.decayed	Wall House Arched Stoneplain Decayed
model.structure.wall.house.arched.stoneplain.upper	Wall House Arched Stoneplain Upper
model.structure.wall.house.arched.stoneplain.upper.decayed	Wall House Arched Stoneplain Upper Decayed
model.structure.wall.house.arched.timber	Wall House Arched Timber
model.structure.wall.house.arched.timber.decayed	Wall House Arched Timber Decayed
model.structure.wall.house.arched.wood	Wall House Arched Wood
model.structure.wall.house.arched.wood.decayed	Wall House Arched Wood Decayed
model.structure.wall.house.archleft.stone	Wall House Archleft Stone
model.structure.wall.house.archleft.stone.decayed	Wall House Archleft Stone Decayed
model.structure.wall.house.archleft.stone.upper	Wall House Archleft Stone Upper
model.structure.wall.house.archleft.stone.upper.decayed	Wall House Archleft Stone Upper Decayed
model.structure.wall.house.archleft.stoneplain	Wall House Archleft Stoneplain
model.structure.wall.house.archleft.stoneplain.decayed	Wall House Archleft Stoneplain Decayed
model.structure.wall.house.archleft.stoneplain.upper	Wall House Archleft Stoneplain Upper
model.structure.wall.house.archleft.stoneplain.upper.decayed	Wall House Archleft Stoneplain Upper Decayed
model.structure.wall.house.archleft.timber	Wall House Archleft Timber
model.structure.wall.house.archleft.timber.decayed	Wall House Archleft Timber Decayed
model.structure.wall.house.archleft.wood	Wall House Archleft Wood
model.structure.wall.house.archleft.wood.decayed	Wall House Archleft Wood Decayed
model.structure.wall.house.archright.stone	Wall House Archright Stone
model.structure.wall.house.archright.stone.decayed	Wall House Archright Stone Decayed
model.structure.wall.house.archright.stone.upper	Wall House Archright Stone Upper
model.structure.wall.house.archright.stone.upper.decayed	Wall House Archright Stone Upper Decayed
model.structure.wall.house.archright.stoneplain	Wall House Archright Stoneplain
model.structure.wall.house.archright.stoneplain.decayed	Wall House Archright Stoneplain Decayed
model.structure.wall.house.archright.stoneplain.upper	Wall House Archright Stoneplain Upper
model.structure.wall.house.archright.stoneplain.upper.decayed	Wall House Archright Stoneplain Upper Decayed
model.structure.wall.house.archright.timber	Wall House Archright Timber
model.structure.wall.house.archright.timber.decayed	Wall House Archright Timber Decayed
model.structure.wall.house.archright.wood	Wall House Archright Wood
model.structure.wall.house.archright.wood.decayed	Wall House Archright Wood Decayed
model.structure.wall.house.archt.stone	Wall House Archt Stone
model.structure.wall.house.archt.stone.decayed	Wall House Archt Stone Decayed
model.structure.wall.house.archt.stone.upper	Wall House Archt Stone Upper
model.structure.wall.house.archt.stone.upper.decayed	Wall House Archt Stone Upper Decayed
model.structure.wall.house.archt.stoneplain	Wall House Archt Stoneplain
model.structure.wall.house.archt.stoneplain.decayed	Wall House Archt Stoneplain Decayed
model.structure.wall.house.archt.stoneplain.upper	Wall House Archt Stoneplain Upper
model.structure.wall.house.archt.stoneplain.upper.decayed	Wall House Archt Stoneplain Upper Decayed
model.structure.wall.house.archt.timber	Wall House Archt Timber
model.structure.wall.house.archt.timber.decayed	Wall House Archt Timber Decayed
model.structure.wall.house.archt.wood	Wall House Archt Wood
model.structure.wall.house.archt.wood.decayed	Wall House Archt Wood Decayed
model.structure.wall.house.balcony.timber	Wall House Balcony Timber
model.structure.wall.house.balcony.timber.decayed	Wall House Balcony Timber Decayed
model.structure.wall.house.bars1.stoneplain	Wall House Bars1 Stoneplain
model.structure.wall.house.bars1.stoneplain.decayed	Wall House Bars1 Stoneplain Decayed
model.structure.wall.house.bars1.stoneplain.upper	Wall House Bars1 Stoneplain Upper
model.structure.wall.house.bars1.stoneplain.upper.decayed	Wall House Bars1 Stoneplain Upper Decayed
model.structure.wall.house.canopy.wood	Wall House Canopy Wood
model.structure.wall.house.canopy.wood.decayed	Wall House Canopy Wood Decayed
model.structure.wall.house.canopy.wood.upper.decayed	Wall House Canopy Wood Upper Decayed
model.structure.wall.house.door.stone	Wall House Door Stone
model.structure.wall.house.door.stone.decayed	Wall House Door Stone Decayed
model.structure.wall.house.door.stone.upper	Wall House Door Stone Upper
model.structure.wall.house.door.stone.upper.decayed	Wall House Door Stone Upper Decayed
model.structure.wall.house.door.stoneplain	Wall House Door Stoneplain
model.structure.wall.house.door.stoneplain.decayed	Wall House Door Stoneplain Decayed
model.structure.wall.house.door.stoneplain.upper	Wall House Door Stoneplain Upper
model.structure.wall.house.door.stoneplain.upper.decayed	Wall House Door Stoneplain Upper Decayed
model.structure.wall.house.door.timber	Wall House Door Timber
model.structure.wall.house.door.timber.decayed	Wall House Door Timber Decayed
model.structure.wall.house.door.timber.upper	Wall House Door Timber Upper
model.structure.wall.house.door.timber.upper.decayed	Wall House Door Timber Upper Decayed
model.structure.wall.house.door.wood	Wall House Door Wood
model.structure.wall.house.door.wood.decayed	Wall House Door Wood Decayed
model.structure.wall.house.doubledoor.stone	Wall House Doubledoor Stone
model.structure.wall.house.doubledoor.stone.decayed	Wall House Doubledoor Stone Decayed
model.structure.wall.house.doubledoor.stone.upper	Wall House Doubledoor Stone Upper
model.structure.wall.house.doubledoor.stone.upper.decayed	Wall House Doubledoor Stone Upper Decayed
model.structure.wall.house.doubledoor.stoneplain	Wall House Doubledoor Stoneplain
model.structure.wall.house.doubledoor.stoneplain.decayed	Wall House Doubledoor Stoneplain Decayed
model.structure.wall.house.doubledoor.stoneplain.upper	Wall House Doubledoor Stoneplain Upper
model.structure.wall.house.doubledoor.stoneplain.upper.decayed	Wall House Doubledoor Stoneplain Upper Decayed
model.structure.wall.house.doubledoor.timber	Wall House Doubledoor Timber
model.structure.wall.house.doubledoor.timber.decayed	Wall House Doubledoor Timber Decayed
model.structure.wall.house.doubledoor.timber.upper	Wall House Doubledoor Timber Upper
model.structure.wall.house.doubledoor.timber.upper.decayed	Wall House Doubledoor Timber Upper Decayed
model.structure.wall.house.doubledoor.wood	Wall House Doubledoor Wood
model.structure.wall.house.doubledoor.wood.decayed	Wall House Doubledoor Wood Decayed
model.structure.wall.house.jetty.timber	Wall House Jetty Timber
model.structure.wall.house.jetty.timber.decayed	Wall House Jetty Timber Decayed
model.structure.wall.house.oriel1.stone	Wall House Oriel1 Stone
model.structure.wall.house.oriel1.stone.decayed	Wall House Oriel1 Stone Decayed
model.structure.wall.house.oriel2.stoneplain	Wall House Oriel2 Stoneplain
model.structure.wall.house.oriel2.stoneplain.decayed	Wall House Oriel2 Stoneplain Decayed
model.structure.wall.house.plan	Wall House Plan
model.structure.wall.house.plan.pottery	Wall House Plan Pottery
model.structure.wall.house.plan.stone	Wall House Plan Stone
model.structure.wall.house.plan.timber	Wall House Plan Timber
model.structure.wall.house.portcullis.stone	Wall House Portcullis Stone
model.structure.wall.house.portcullis.stone.decayed	Wall House Portcullis Stone Decayed
model.structure.wall.house.portcullis.stone.upper	Wall House Portcullis Stone Upper
model.structure.wall.house.portcullis.stone.upper.decayed	Wall House Portcullis Stone Upper Decayed
model.structure.wall.house.portcullis.stoneplain	Wall House Portcullis Stoneplain
model.structure.wall.house.portcullis.stoneplain.decayed	Wall House Portcullis Stoneplain Decayed
model.structure.wall.house.portcullis.stoneplain.upper	Wall House Portcullis Stoneplain Upper
model.structure.wall.house.portcullis.stoneplain.upper.decayed	Wall House Portcullis Stoneplain Upper Decayed
model.structure.wall.house.portcullis.wood	Wall House Portcullis Wood
model.structure.wall.house.portcullis.wood.decayed	Wall House Portcullis Wood Decayed
model.structure.wall.house.stone	Wall House Stone
model.structure.wall.house.stone.decayed	Wall House Stone Decayed
model.structure.wall.house.stone.oriel2	Wall House Stone Oriel2
model.structure.wall.house.stone.upper	Wall House Stone Upper
model.structure.wall.house.stone.upper.decayed	Wall House Stone Upper Decayed
model.structure.wall.house.stoneplain	Wall House Stoneplain
model.structure.wall.house.stoneplain.decayed	Wall House Stoneplain Decayed
model.structure.wall.house.stoneplain.upper	Wall House Stoneplain Upper
model.structure.wall.house.stoneplain.upper.decayed	Wall House Stoneplain Upper Decayed
model.structure.wall.house.timber	Wall House Timber
model.structure.wall.house.timber.decayed	Wall House Timber Decayed
model.structure.wall.house.timber.upper	Wall House Timber Upper
model.structure.wall.house.timber.upper.decayed	Wall House Timber Upper Decayed
model.structure.wall.house.widewindow.wood	Wall House Widewindow Wood
model.structure.wall.house.widewindow.wood.decayed	Wall House Widewindow Wood Decayed
model.structure.wall.house.window.stone	Wall House Window Stone
model.structure.wall.house.window.stone.decayed	Wall House Window Stone Decayed
model.structure.wall.house.window.stone.upper	Wall House Window Stone Upper
model.structure.wall.house.window.stone.upper.decayed	Wall House Window Stone Upper Decayed
model.structure.wall.house.window.stoneplain	Wall House Window Stoneplain
model.structure.wall.house.window.stoneplain.decayed	Wall House Window Stoneplain Decayed
model.structure.wall.house.window.stoneplain.upper	Wall House Window Stoneplain Upper
model.structure.wall.house.window.stoneplain.upper.decayed	Wall House Window Stoneplain Upper Decayed
model.structure.wall.house.window.timber	Wall House Window Timber
model.structure.wall.house.window.timber.decayed	Wall House Window Timber Decayed
model.structure.wall.house.window.timber.upper	Wall House Window Timber Upper
model.structure.wall.house.window.timber.upper.decayed	Wall House Window Timber Upper Decayed
model.structure.wall.house.window.wood	Wall House Window Wood
model.structure.wall.house.window.wood.decayed	Wall House Window Wood Decayed
model.structure.wall.house.windownarrow.stoneplain	Wall House Windownarrow Stoneplain
model.structure.wall.house.windownarrow.stoneplain.decayed	Wall House Windownarrow Stoneplain Decayed
model.structure.wall.house.windownarrow.stoneplain.upper	Wall House Windownarrow Stoneplain Upper
model.structure.wall.house.windownarrow.stoneplain.upper.decayed	Wall House Windownarrow Stoneplain Upper Decayed
model.structure.wall.house.wood.decayed	Wall House Wood Decayed
model.structure.wall.rubble	Wall Rubble
model.structure.war.supplydepot.1.1	War Supplydepot 1 1
model.structure.war.supplydepot.1.2	War Supplydepot 1 2
model.structure.war.supplydepot.2	War Supplydepot 2
model.structure.war.supplydepot.3.1	War Supplydepot 3 1
model.structure.war.supplydepot.3.2	War Supplydepot 3 2
model.stump.applewood	Stump Applewood
model.stump.birchwood	Stump Birchwood
model.stump.cedarwood	Stump Cedarwood
model.stump.cherrywood	Stump Cherrywood
model.stump.chestnut	Stump Chestnut
model.stump.firwood	Stump Firwood
model.stump.lemonwood	Stump Lemonwood
model.stump.lindenwood	Stump Lindenwood
model.stump.maplewood	Stump Maplewood
model.stump.oakenwood	Stump Oakenwood
model.stump.olivewood	Stump Olivewood
model.stump.pinewood	Stump Pinewood
model.stump.walnut	Stump Walnut
model.stump.willow	Stump Willow
model.terrain.decoration.fern1	Terrain Decoration Fern1
model.terrain.decoration.fern2	Terrain Decoration Fern2
model.terrain.decoration.fern2.fall	Terrain Decoration Fern2 Fall
model.terrain.decoration.fern3	Terrain Decoration Fern3
model.terrain.decoration.rock1	Terrain Decoration Rock1
model.terrain.decoration.rock2	Terrain Decoration Rock2
model.terrain.decoration.rock3	Terrain Decoration Rock3
model.terrain.farm.pumpkin1	Terrain Farm Pumpkin1
model.terrain.farm.pumpkin2	Terrain Farm Pumpkin2
model.terrain.farm.pumpkin3	Terrain Farm Pumpkin3
model.terrain.farm.pumpkin4	Terrain Farm Pumpkin4
model.tool.anchor	Anchor
model.tool.anchor.rope	Anchor Rope
model.tool.anvil	Anvil
model.tool.anvil.large.iron	Anvil Large Iron
model.tool.awl	Awl
model.tool.bagkeeping	Bagkeeping
model.tool.beesmoker.iron	Beesmoker Iron
model.tool.beesmoker.iron.smoke	Beesmoker Iron Smoke
model.tool.beesmoker.unfinished	Beesmoker Unfinished
model.tool.belaying	Belaying
model.tool.blade.awl	Blade Awl
model.tool.blade.chisel	Blade Chisel
model.tool.blade.file	Blade File
model.tool.blade.file.iron	Blade File Iron
model.tool.blade.hammer	Blade Hammer
model.tool.blade.hammer.iron	Blade Hammer Iron
model.tool.blade.rake	Blade Rake
model.tool.blade.scissors	Blade Scissors
model.tool.blade.trowel	Blade Trowel
model.tool.brandingiron	Brandingiron
model.tool.cauldron	Cauldron
model.tool.cheesedrill	Cheesedrill
model.tool.cheesedrill.decayed	Cheesedrill Decayed
model.tool.chisel	Chisel
model.tool.chisel.iron	Chisel Iron
model.tool.clayshaper	Clayshaper
model.tool.crowbar	Crowbar
model.tool.crowbar.3	Crowbar 3
model.tool.dioptra	Dioptra
model.tool.dioptra.unfinished	Dioptra Unfinished
model.tool.file	File
model.tool.fish.hook	Fish Hook
model.tool.fish.hook.bone	Fish Hook Bone
model.tool.fish.hook.iron	Fish Hook Iron
model.tool.fish.rod.ironhook	Fish Rod Ironhook
model.tool.food.fork	Food Fork
model.tool.food.knife	Food Knife
model.tool.food.spoon	Food Spoon
model.tool.fruitpress	Fruitpress
model.tool.fruitpress.decayed	Fruitpress Decayed
model.tool.fruitpress.unfinished	Fruitpress Unfinished
model.tool.fryingpan.iron	Fryingpan Iron
model.tool.fryingpan.iron	Fryingpan Iron
model.tool.grinder.stone	Grinder Stone
model.tool.groomingbrush	Groomingbrush
model.tool.hammer	Hammer
model.tool.hammer.iron	Hammer Iron
model.tool.handmirror.gold	Handmirror Gold
model.tool.handmirror.silver	Handmirror Silver
model.tool.leatherknife	Leatherknife
model.tool.leatherknife.glimmersteel	Leatherknife Glimmersteel
model.tool.leggat	Leggat
model.tool.loom	Loom
model.tool.loom.unfinished	Loom Unfinished
model.tool.metalbrush	Metalbrush
model.tool.mortarandpestle	Mortarandpestle
model.tool.nails.large	Nails Large
model.tool.nails.small	Nails Small
model.tool.needle	Needle
model.tool.needle.copper	Needle Copper
model.tool.needle.copper	Needle Copper
model.tool.pickaxe	Pickaxe
model.tool.pickaxe.blade.crude	Pickaxe Blade Crude
model.tool.pickaxe.blade.iron	Pickaxe Blade Iron
model.tool.pickaxe.crude	Pickaxe Crude
model.tool.pickaxe.glimmersteel	Pickaxe Glimmersteel
model.tool.pickaxe.iron	Pickaxe Iron
model.tool.pliers	Pliers
model.tool.press	Press
model.tool.press.unfinished	Press Unfinished
model.tool.protractor	Protractor
model.tool.rake	Rake
model.tool.rangepole	Rangepole
model.tool.reedpen	Reedpen
model.tool.rodtrans.stone	Rodtrans Stone
model.tool.ropetool.small	Ropetool Small
model.tool.saucepan.iron	Saucepan Iron
model.tool.saucepan.iron	Saucepan Iron
model.tool.saw	Saw
model.tool.scissors	Scissors
model.tool.shovel	Shovel
model.tool.shovel.blade	Shovel Blade
model.tool.shovel.blade.crude	Shovel Blade Crude
model.tool.shovel.crude	Shovel Crude
model.tool.shovel.glimmersteel	Shovel Glimmersteel
model.tool.sight.bronze	Sight Bronze
model.tool.small.flintandsteel.steel	Small Flintandsteel Steel
model.tool.spatula	Spatula
model.tool.spatula	Spatula
model.tool.spindle	Spindle
model.tool.trowel	Trowel
model.tool.wheel.spinning	Wheel Spinning
model.tool.wheel.spinning.unfinished	Wheel Spinning Unfinished
model.tool.whet.stone	Whet Stone
model.toy.puppet.fo.cotton	Toy Puppet Fo Cotton
model.toy.puppet.libila.cotton	Toy Puppet Libila Cotton
model.toy.puppet.magranon.cotton	Toy Puppet Magranon Cotton
model.toy.puppet.vynora.cotton	Toy Puppet Vynora Cotton
model.toy.puppet.vynora.unfinished	Toy Puppet Vynora Unfinished
model.toy.yoyo	Toy Yoyo
model.transports.large.creature.transporter.loaded	Transports Large Creature Transporter Loaded
model.transports.large.creature.transporter.unloaded	Transports Large Creature Transporter Unloaded
model.transports.large.ship.transporter.loaded	Transports Large Ship Transporter Loaded
model.transports.large.ship.transporter.unfinished	Transports Large Ship Transporter Unfinished
model.transports.large.ship.transporter.unloaded	Transports Large Ship Transporter Unloaded
model.transports.medium.wagon	Transports Medium Wagon
model.transports.medium.wagon.free	Transports Medium Wagon Free
model.transports.medium.wagon.unfinished	Transports Medium Wagon Unfinished
model.transports.medium.wagon.wagoner.loaded	Transports Medium Wagon Wagoner Loaded
model.transports.medium.wagon.wagoner.unloaded	Transports Medium Wagon Wagoner Unloaded
model.trap.axe	Trap Axe
model.trap.bow	Trap Bow
model.trap.corrosive	Trap Corrosive
model.trap.knife	Trap Knife
model.trap.man	Trap Man
model.trap.net	Trap Net
model.trap.pole	Trap Pole
model.trap.rope	Trap Rope
model.trap.scythe	Trap Scythe
model.trap.sticks	Trap Sticks
model.tree	Tree
model.tree.apple	Tree Apple
model.tree.apple.spring	Tree Apple Spring
model.tree.apple.young	Tree Apple Young
model.tree.apple.young.spring	Tree Apple Young Spring
model.tree.birch	Tree Birch
model.tree.birch.fall	Tree Birch Fall
model.tree.birch.young	Tree Birch Young
model.tree.birch.young.fall	Tree Birch Young Fall
model.tree.cedar	Tree Cedar
model.tree.cedar.winter	Tree Cedar Winter
model.tree.cedar.young	Tree Cedar Young
model.tree.cedar.young.winter	Tree Cedar Young Winter
model.tree.cherry	Tree Cherry
model.tree.cherry.spring	Tree Cherry Spring
model.tree.cherry.young	Tree Cherry Young
model.tree.cherry.young.spring	Tree Cherry Young Spring
model.tree.chestnut	Tree Chestnut
model.tree.chestnut.spring	Tree Chestnut Spring
model.tree.chestnut.young	Tree Chestnut Young
model.tree.chestnut.young.spring	Tree Chestnut Young Spring
model.tree.fir	Tree Fir
model.tree.fir.winter	Tree Fir Winter
model.tree.fir.young	Tree Fir Young
model.tree.fir.young.winter	Tree Fir Young Winter
model.tree.lemon	Tree Lemon
model.tree.lemon.spring	Tree Lemon Spring
model.tree.lemon.young	Tree Lemon Young
model.tree.lemon.young.spring	Tree Lemon Young Spring
model.tree.linden	Tree Linden
model.tree.linden.spring	Tree Linden Spring
model.tree.linden.young	Tree Linden Young
model.tree.linden.young.spring	Tree Linden Young Spring
model.tree.maple	Tree Maple
model.tree.maple.fall	Tree Maple Fall
model.tree.maple.young	Tree Maple Young
model.tree.maple.young.fall	Tree Maple Young Fall
model.tree.oak	Tree Oak
model.tree.oak	Tree Oak
model.tree.oak.fall	Tree Oak Fall
model.tree.oak.young	Tree Oak Young
model.tree.oak.young.fall	Tree Oak Young Fall
model.tree.olive	Tree Olive
model.tree.olive.fall	Tree Olive Fall
model.tree.olive.young	Tree Olive Young
model.tree.olive.young.fall	Tree Olive Young Fall
model.tree.orange	Tree Orange
model.tree.orange.spring	Tree Orange Spring
model.tree.orange.young	Tree Orange Young
model.tree.orange.young.spring	Tree Orange Young Spring
model.tree.pine	Tree Pine
model.tree.pine.winter	Tree Pine Winter
model.tree.pine.young	Tree Pine Young
model.tree.pine.young.winter	Tree Pine Young Winter
model.tree.walnut	Tree Walnut
model.tree.walnut.spring	Tree Walnut Spring
model.tree.walnut.young	Tree Walnut Young
model.tree.walnut.young.spring	Tree Walnut Young Spring
model.tree.willow	Tree Willow
model.tree.willow.fall	Tree Willow Fall
model.tree.willow.young	Tree Willow Young
model.tree.willow.young.fall	Tree Willow Young Fall
model.valrei.magic	Valrei Magic
model.weapon.axe.large	Axe Large
model.weapon.axe.large.adamantine	Axe Large Adamantine
model.weapon.axe.large.blade	Axe Large Blade
model.weapon.axe.large.blade.adamantine	Axe Large Blade Adamantine
model.weapon.axe.medium	Axe Medium
model.weapon.axe.medium.adamantine	Axe Medium Adamantine
model.weapon.axe.medium.blade	Axe Medium Blade
model.weapon.axe.medium.blade.adamantine	Axe Medium Blade Adamantine
model.weapon.axe.small	Axe Small
model.weapon.axe.small.adamantine	Axe Small Adamantine
model.weapon.axe.small.blade	Axe Small Blade
model.weapon.axe.small.blade.adamantine	Axe Small Blade Adamantine
model.weapon.blade.halberd	Blade Halberd
model.weapon.blade.halberd.adamantine	Blade Halberd Adamantine
model.weapon.blade.knife.butchering	Blade Knife Butchering
model.weapon.blade.knife.carving	Blade Knife Carving
model.weapon.blade.scythe	Blade Scythe
model.weapon.blade.sickle	Blade Sickle
model.weapon.blade.spear.long	Blade Spear Long
model.weapon.blade.spear.long.adamantine	Blade Spear Long Adamantine
model.weapon.blade.swordlong	Blade Swordlong
model.weapon.blade.swordlong.adamantine	Blade Swordlong Adamantine
model.weapon.blade.swordshort	Blade Swordshort
model.weapon.blade.swordshort.adamantine	Blade Swordshort Adamantine
model.weapon.blade.swordtwo	Blade Swordtwo
model.weapon.blade.swordtwo.adamantine	Blade Swordtwo Adamantine
model.weapon.club.huge	Club Huge
model.weapon.hatchet	Hatchet
model.weapon.hatchet.blade	Hatchet Blade
model.weapon.hatchet.glimmersteel	Hatchet Glimmersteel
model.weapon.head.large.maul	Head Large Maul
model.weapon.head.medium.maul	Head Medium Maul
model.weapon.head.small.maul	Head Small Maul
model.weapon.knife.butchering	Knife Butchering
model.weapon.knife.carving	Knife Carving
model.weapon.knife.carving.glimmersteel	Knife Carving Glimmersteel
model.weapon.knife.carving.iron	Knife Carving Iron
model.weapon.knife.crude	Knife Crude
model.weapon.knife.sacrificial.silver	Knife Sacrificial Silver
model.weapon.maul.large	Maul Large
model.weapon.maul.medium	Maul Medium
model.weapon.maul.small	Maul Small
model.weapon.polearm.halberd	Polearm Halberd
model.weapon.polearm.halberd.adamantine	Polearm Halberd Adamantine
model.weapon.polearm.spear	Polearm Spear
model.weapon.polearm.spear.adamantine	Polearm Spear Adamantine
model.weapon.polearm.spear.long	Polearm Spear Long
model.weapon.polearm.spear.long.adamantine	Polearm Spear Long Adamantine
model.weapon.polearm.staff	Polearm Staff
model.weapon.polearm.staff.adamantine	Polearm Staff Adamantine
model.weapon.polearm.staff.diamond	Polearm Staff Diamond
model.weapon.polearm.staff.emerald	Polearm Staff Emerald
model.weapon.polearm.staff.opal	Polearm Staff Opal
model.weapon.polearm.staff.ruby	Polearm Staff Ruby
model.weapon.polearm.staff.sapphire	Polearm Staff Sapphire
model.weapon.polearm.staff.steel	Polearm Staff Steel
model.weapon.scythe	Scythe
model.weapon.scythe	Scythe
model.weapon.scythe.glimmersteel	Scythe Glimmersteel
model.weapon.sickle	Sickle
model.weapon.staffOfLand	StaffOfLand
model.weapon.swordlong	Swordlong
model.weapon.swordlong.adamantine	Swordlong Adamantine
model.weapon.swordshort	Swordshort
model.weapon.swordshort.adamantine	Swordshort Adamantine
model.weapon.swordtwo	Swordtwo
model.weapon.swordtwo.adamantine	Swordtwo Adamantine
model.weapon.whip	Whip
model.writ	Writ
tutorial.object.1	Tutorial Object 1
tutorial.object.19	Tutorial Object 19
tutorial.object.30	Tutorial Object 30
tutorial.object.31	Tutorial Object 31
tutorial.object.32	Tutorial Object 32
tutorial.object.33	Tutorial Object 33
tutorial.object.36	Tutorial Object 36
tutorial.object.4	Tutorial Object 4
tutorial.object.41	Tutorial Object 41
tutorial.object.42	Tutorial Object 42
tutorial.object.43	Tutorial Object 43
tutorial.object.48	Tutorial Object 48
tutorial.object.53	Tutorial Object 53
tutorial.object.54	Tutorial Object 54
tutorial.object.58	Tutorial Object 58
tutorial.object.59	Tutorial Object 59
tutorial.object.60	Tutorial Object 60
tutorial.object.61	Tutorial Object 61
tutorial.object.62	Tutorial Object 62
tutorial.object.63	Tutorial Object 63
tutorial.object.65	Tutorial Object 65
tutorial.object.73	Tutorial Object 73
tutorial.object.74	Tutorial Object 74
tutorial.object.76	Tutorial Object 76
tutorial.object.77	Tutorial Object 77
tutorial.object.82	Tutorial Object 82
tutorial.object.83	Tutorial Object 83
tutorial.object.84	Tutorial Object 84
tutorial.object.85	Tutorial Object 85
